Date,Address,Location,Boarea,Biarea,Totalarea,Rooms,Tomt_area,Closing_Price
Såld 9 oktober 2023,Skårby station 350,"Kareby,",143,25,168,7,2 303,3005000
Såld 5 oktober 2023,Högalidsgatan 3,"Centrum,",103,103,206,5,862,3800000
Såld 3 oktober 2023,Kungälvsvägen 22,"Centralt,",77,46,123,5,1 548,4500000
Såld 2 oktober 2023,Ädelstensvägen 58,"Kode,",123,6,129,6,379,4075000
Såld 27 september 2023,Kantorvägen 4,"Bohuslän,",166,6,172,6,558,3625000
Såld 26 september 2023,Diamantvägen 34,"Kode,",123,5,128,5,559,2900000
Såld 25 september 2023,Tjäderstigen 8,"Centralt,",126,4,130,4,362,4760000
Såld 22 september 2023,Heavägen 31,"Lycke,",165,30,195,6,1 553,5450000
Såld 17 september 2023,Beryllvägen 14,"Kode,",145,5,150,5,434,3900000
Såld 17 september 2023,Kornhall 290,"Kornhall,",134,7,141,5,1 706,6100000
Såld 15 september 2023,Grindbacken 18,"Grinden,",124,4,128,4,932,7350000
Såld 15 september 2023,Korpvägen 273,"Ullstorp,",112,4,116,4,480,5050000
Såld 13 september 2023,Kristiansborg 300,"Bohuslän,",215,115,330,5,3 121,5350000
Såld 7 september 2023,Glöskär 255,"Kärna,",111,22,133,4,2 062,3520000
Såld 6 september 2023,Nolby 150,"Kode,",129,4,133,4,1 724,4100000
Såld 5 september 2023,Skårby station 452,"Kareby,",122,2,124,2,2 963,4395000
Såld 31 augusti 2023,Snäckvägen 11,"Kode,",39,3,42,3,1 593,2150000
Såld 31 augusti 2023,Klockarvägen 1,"Bohuslän,",137,5,142,5,884,3000000
Såld 30 augusti 2023,Lilla Fjellsholmen 35,"Vedhall,",86,3,89,3,427,10000000
Såld 29 augusti 2023,Västra Röd 165,"Kärna,",151,20,171,5,2 263,5995000
Såld 24 augusti 2023,Snorregatan 3B,"Komarken,",120,3,123,5,342,4225000
Såld 23 augusti 2023,Jägarvägen 13,"Romelanda,",162,14,176,5,569,3900000
Såld 23 augusti 2023,Rosenstensvägen 2,"Kungälv,",140,5,145,5,673,4800000
Såld 16 augusti 2023,Tröskvägen 260,"Ullstorp,",135,6,141,6,410,5600000
Såld 16 augusti 2023,Stora Lycke 400,"Bohuslän,",111,5,116,5,761,3650000
Såld 15 augusti 2023,Dösebacka 410,"Romelanda,",38,11,49,3,5 960,2300000
Såld 9 augusti 2023,Mantalsgatan 9,"Tega,",175,35,210,7,1 105,4725000
Såld 8 augusti 2023,Skälebräckeliden 9,"Centrum,",113,85,198,4,1 608,6275000
Såld 4 augusti 2023,Norrmannebo 700,"Romelanda,",41,3,44,3,1 182,1000000
Såld 28 juli 2023,Bokvägen 14,"Fontin, centrum,",137,6,143,6,828,5100000
Såld 17 juli 2023,Duvesjön 228,"Romelanda,",121,37,158,5,1 150,4195000
Såld 17 juli 2023,Klintegatan 22,"Centralt,",119,55,174,5,999,6500000
Såld 13 juli 2023,Galärgatan 2,"Kungälv Centrum,",103,60,163,5,749,4300000
Såld 13 juli 2023,Ulvebackegatan 3,"Munkegärde,",129,44,173,5,927,4850000
Såld 11 juli 2023,Vråstigen 4,"Överön,",81,57,138,4,2 619,3775000
Såld 7 juli 2023,Bergsvägen 11,"Rörtången/ Ödsmålsmosse,",69,4,73,4,934,2000000
Såld 6 juli 2023,Lundby 509,"Kareby,",166,6,172,6,1 933,4900000
Såld 6 juli 2023,Kastellegårdsgatan 29,"Komarken,",122,16,138,4,1 033,5200000
Såld 4 juli 2023,Sparråsvägen 140,"Kungälv - Ytterby,",137,19,156,4,961,3850000
Såld 4 juli 2023,Dammen 160,"Kärna,",174,25,199,5,3 234,3450000
Såld 4 juli 2023,Önneröd 220,"Kärna,",112,4,116,4,2 032,4200000
Såld 3 juli 2023,Tulpanvägen 15,"Kärna,",105,140,245,4,914,3900000
Såld 2 juli 2023,Rubinvägen 19,"Kode,",195,7,202,7,937,5050000
Såld 30 juni 2023,Gårdskiftegatan 5,"Ytterby,",164,36,200,5,806,5250000
Såld 30 juni 2023,Norrmannebo 270,"Romelanda, Kungälvs kommun,",114,110,224,7,1 400,4300000
Såld 29 juni 2023,Dösebacka 120,"Romelanda,",64,53,117,3,3 824,2960000
Såld 28 juni 2023,Kärnavägen 16,"Kärna,",171,83,254,7,695,4300000
Såld 22 juni 2023,Torp 250,"Kareby,",159,48,207,4,1 608,3950000
Såld 21 juni 2023,Korpvägen 279,"Ullstorp,",133,24,157,4,522,5850000
Såld 21 juni 2023,Västra gatan 48,"Kungälv - Centralt,",136,5,141,5,937,6500000
Såld 18 juni 2023,Gunneröd 506,"Kärna,",138,6,144,6,1 215,4930000
Såld 18 juni 2023,Oxelvägen 96,"Diseröd,",139,5,144,5,390,4200000
Såld 16 juni 2023,Solberg 420,"Romelanda,",90,65,155,3,2 968,2350000
Såld 15 juni 2023,Kovikshamn 160,"Kovikshamn,",124,8,132,4,1 400,4300000
Såld 14 juni 2023,Blankas gata 3,"Kungälv - Centralt,",130,152,282,7,980,6350000
Såld 14 juni 2023,Ljungvägen 20,"Kode,",34,2,36,2,304,2370000
Såld 14 juni 2023,Rubinvägen 27,"Kode,",195,6,201,6,991,3500000
Såld 8 juni 2023,Ulvesund 419,"Kungälv - Ulvesund,",65,2,67,2,688,3000000
Såld 8 juni 2023,Erslycke 140,"Lycke,",162,24,186,5,1 820,5700000
Såld 3 juni 2023,Önneröd 145,"Kärna,",110,4,114,4,1 030,4675000
Såld 2 juni 2023,Ställets bygata 156,"Ytterby,",146,7,153,7,742,6495000
Såld 1 juni 2023,Hallebäcksvägen 24,"Timmervik,",105,4,109,4,1 337,5250000
Såld 1 juni 2023,Bergkristallvägen 8,"Kode,",127,8,135,4,518,4795000
Såld 1 juni 2023,Hammarhöjden 670,"Bohuslän,",100,47,147,,1 090,3200000
Såld 1 juni 2023,Sålådevägen 554,"Ullstorp,",173,6,179,6,800,8600000
Såld 31 maj 2023,Hjälmgatan 7,"Ytterby,",96,3,99,3,463,4000000
Såld 31 maj 2023,Strömgatan 9,"Ytterby,",127,5,132,5,890,6295000
Såld 25 maj 2023,Krappvägen 570,"Ullstorp,",230,25,255,8,788,9500000
Såld 19 maj 2023,Norrmannebo 650,"Bohuslän,",143,50,193,6,20 500,5800000
Såld 18 maj 2023,Ängsgatan  23,"Centralt,",91,87,178,5,743,4625000
Såld 18 maj 2023,Stenåldersgatan 14,"Stället,",107,5,112,5,452,5050000
Såld 17 maj 2023,Spaghamnsvägen 7,"Tjuvkil,",110,5,115,5,1 664,5000000
Såld 17 maj 2023,Östergårdsgatan 3,"Ytterby,",215,62,277,7,1 020,4860000
Såld 16 maj 2023,Romelanda nedergård 160,"Romelanda,",139,5,144,5,1 196,2625000
Såld 15 maj 2023,Toreby 240,"Kärna,",89,89,178,5,1 245,3405000
Såld 12 maj 2023,Murhammarvägen 12,"Kungälv - Kareby,",174,17,191,6,700,5200000
Såld 8 maj 2023,Kämpegatan 4,"Kungälv Centrum,",128,43,171,5,1 160,5000000
Såld 7 maj 2023,Vesslegatan 14,"Olseröd,",159,17,176,5,349,5550000
Såld 4 maj 2023,Bastubäcksvägen 26,"Kode,",44,36,80,4,1 199,1775000
Såld 2 maj 2023,Karantänsgatan 9,"Kungälv Centrum,",130,6,136,6,659,4500000
Såld 30 april 2023,Vävra 297,"Hålta,",161,55,216,5,1 587,5300000
Såld 29 april 2023,Lerskärsvägen 8,"Tjuvkil,",84,50,134,4,1 458,4500000
Såld 26 april 2023,Brunnefjällsvägen 21,"Kärna,",82,13,95,3,1 741,3500000
Såld 26 april 2023,Klockarvägen 7,"Kungälv - Romelanda,",162,6,168,6,706,4050000
Såld 25 april 2023,Sålådevägen 546,"Kungälv - Ullstorp,",145,19,164,5,804,6700000
Såld 21 april 2023,Östra Trädal 320,"Ytterby,",130,50,180,6,8 185,7495000
Såld 20 april 2023,Lundby 565,"Kareby,",101,3,104,3,1 935,4390000
Såld 18 april 2023,Kuskalundsvägen 39,"Kungälv - Hålta,",70,13,83,3,1 745,2600000
Såld 18 april 2023,Häradsvägen 6,"Ytterby,",137,7,144,7,468,4250000
Såld 18 april 2023,Kareby kyrkväg 149,"Kareby,",137,5,142,5,1 951,4300000
Såld 15 april 2023,Kuskalundsvägen 32,"Hålta,",79,3,82,3,1 494,3050000
Såld 15 april 2023,Munkegärdegatan 243,"Munkegärde/Ulvegärde,",133,6,139,6,817,5150000
Såld 14 april 2023,Backsippegatan 5,"Ytterby,",115,5,120,5,598,4200000
Såld 10 april 2023,Stora Risby 550,"Hålta,",100,86,186,3,1 640,3850000
Såld 3 april 2023,Västra gatan 28,"Kungälv - Centralt,",155,32,187,6,600,5250000
Såld 30 mars 2023,Östergårdsgatan 23,"Ytterby,",180,48,228,6,840,5225000
Såld 27 mars 2023,Hermansby 165,"Kärna,",134,4,138,4,2 005,4900000
Såld 24 mars 2023,Lefstad 155,"Kärna,",145,6,151,6,1 545,5700000
Såld 24 mars 2023,Kullegatan 12,"Centrum,",190,163,353,7,660,6600000
Såld 23 mars 2023,Bräcke 105,"Kungälv - Kärna,",204,6,210,6,1 906,5295000
Såld 23 mars 2023,Kulperödsvägen 17,"Bohuslän,",133,119,252,6,2 141,4800000
Såld 9 mars 2023,Sköldgatan 8,"Stället,",96,29,125,3,451,4225000
Såld 9 mars 2023,Munkegärdegatan 279,"Kungälv - Munkegärde,",118,4,122,4,342,4700000
Såld 8 mars 2023,Önneröd 120,"Kärna,",133,29,162,5,3 061,3750000
Såld 3 mars 2023,Kyrkeby 293,"Harestad,",170,6,176,6,1 189,5500000
Såld 2 mars 2023,Harkeröd 305,"Hålta,",110,4,114,4,818,4395000
Såld 2 mars 2023,Lagvägen 23,"Ytterby,",107,7,114,4,757,2700000
Såld 27 februari 2023,Tegskiftegatan 84,"Ytterby,",101,146,247,5,1 186,5310000
Såld 21 februari 2023,Signehög 320,"Romelanda,",105,57,162,5,1 550,4350000
Såld 8 februari 2023,Guddehjälm 215,"Ytterby,","182,5",8,,8,3 639,5330000
Såld 7 februari 2023,Kärnavägen 4,"Kärna,",110,90,200,7,860,4250000
Såld 4 februari 2023,Källeröd 166,"Kareby,",127,6,133,6,988,4350000
Såld 2 februari 2023,Korpedalsvägen 3,"Aröd,",140,64,204,5,993,4000000
Såld 30 januari 2023,Hällristningsgatan 10,"Kungälv - Ytterby,",103,4,107,4,282,4000000
Såld 27 januari 2023,Kantorvägen 4,"Diseröd,",134,5,139,5,558,3700000
Såld 26 januari 2023,Gunneröd 320,"Lycke,",145,5,150,5,1 144,3900000
Såld 19 januari 2023,Prästvägen 340,"Kungälv - Kareby,",158,92,250,7,4 235,6100000
Såld 18 januari 2023,Granndalen 13,"Kärna,",110,27,137,4,1 093,3850000
Såld 17 januari 2023,Stenåldersgatan 57,"Ytterby,",107,5,112,5,354,4380000
Såld 12 januari 2023,Duvesjön 216,"Romelanda,",153,6,159,6,2 091,4750000
Såld 4 januari 2023,Rostock 290,"Romelanda,",148,65,213,,1 678,3400000
Såld 27 december 2022,Långdammsvägen 2,"Marstrandsön,",28,0,28,,617,7125000
Såld 21 december 2022,Munkegärdegatan 312,"Munkegärde,",170,6,176,6,612,5605000
Såld 15 december 2022,Bremnäs 130,"Lycke,",167,40,207,8,938,4490000
Såld 13 december 2022,Bremnäs 155,"Lycke Bremnäs,",137,53,190,6,1 298,4125000
Såld 2 december 2022,Skurhagagatan 3,"Komarken,",127,125,252,6,603,4700000
Såld 2 december 2022,Över-Restad 165,"Hålta,",126,6,132,6,1 693,5050000
Såld 2 december 2022,Sundhammarsvägen 610,"Kärna,",188,6,194,6,2 010,5500000
Såld 2 december 2022,Klevevägen 50,"Ytterby,",110,4,114,4,2 010,3600000
Såld 1 december 2022,Klockarvägen 11,"Diseröd,",170,6,176,6,574,4300000
Såld 29 november 2022,Hammarberg 830,"Kode,",73,15,88,3,1 632,2900000
Såld 24 november 2022,Jordliden 30,"Kungälv,",86,3,89,3,1 632,2750000
Såld 24 november 2022,Grindklykan 9,"Grinden,",114,4,118,4,729,4800000
Såld 18 november 2022,Hältorp 130,"Ytterby,",115,115,230,7,1 372,4050000
Såld 17 november 2022,Häljeröd 430,"Romelanda,",132,6,138,6,3 009,4515000
Såld 13 november 2022,Sjöhåla 130,"Sjöhåla,",121,75,196,4,1 576,2400000
Såld 12 november 2022,Flädervägen 18,"Romelanda,",137,20,157,6,353,3850000
Såld 11 november 2022,Lundby 440,"Kareby,",125,120,245,5,1 676,4500000
Såld 10 november 2022,Fiolmannens gata 17,"Ytterby,",115,5,120,5,1 676,3995000
Såld 6 november 2022,Lefstad 350,"Kärna,",129,90,219,6,2 216,4050000
Såld 3 november 2022,Enskiftegatan 10,"Kungälv - Ytterby,",179,6,185,6,768,5500000
Såld 31 oktober 2022,Mossvägen 38,"Lökeberg,",86,3,89,3,1 111,4400000
Såld 26 oktober 2022,Lingången 16,"Kungälv - Centrum,",120,4,124,4,402,4550000
Såld 21 oktober 2022,Jägersberg 310,"Kode,",184,28,212,6,26 210,4000000
Såld 19 oktober 2022,Mossvägen 37,"Lökeberg,",86,3,89,3,1 844,4400000
Såld 16 oktober 2022,Prejelvägen 120,"Ullstorp,",122,5,127,5,314,5495000
Såld 12 oktober 2022,Vältvägen 509,"Ullstorp,",105,4,109,4,319,5050000
Såld 12 oktober 2022,Björröd 310,"Kode,",172,6,178,6,1 514,4350000
Såld 3 oktober 2022,Kullholmsvägen 6,"Tjuvkil,",117,5,122,5,429,5900000
Såld 30 september 2022,Kantorvägen 8,"Diseröd,",125,4,129,4,557,3700000
Såld 29 september 2022,Norrmannebo 110,"Romelanda,",99,3,102,3,1 720,2100000
Såld 29 september 2022,Heden 220,"Bohuslän,",123,77,200,5,3 342,4750000
Såld 28 september 2022,Gustavsbergsvägen 16,"Ytterby,",105,91,196,4,1 244,5100000
Såld 27 september 2022,Bergsvägen 28,"Ödsmålsmosse,",58,7,65,3,1 631,3075000
Såld 24 september 2022,Korpvägen 263,"Ullstorp,",158,18,176,6,387,6500000
Såld 22 september 2022,Hemvägen 48,"Diseröd,",130,65,195,5,696,3650000
Såld 19 september 2022,Häljeröd 640,"Kode,",211,8,219,8,47 500,7750000
Såld 17 september 2022,Stenåldersgatan 55,"Ytterby,",120,15,135,5,395,5200000
Såld 12 september 2022,Annas väg 28,"Kovikshamn/Sundhammar,",101,3,104,3,1 118,4150000
Såld 11 september 2022,Krokebäcksvägen 95,"Kareby,",123,5,128,5,259,5100000
Såld 10 september 2022,Björröd 260,"Bohuslän,",145,4,149,4,4 156,3300000
Såld 9 september 2022,Vävra 105,"Hålta,",111,2,113,2,1 943,2550000
Såld 8 september 2022,Högsberg 355,"Kode,",94,4,98,4,1 797,4050000
Såld 8 september 2022,Rådjursgatan 8,"Bohuslän,",85,3,88,3,1 797,3195000
Såld 6 september 2022,Barlinds väg 38,"Instön,",98,2,100,4,1 290,8500000
Såld 4 september 2022,Skålgropsgatan 28,"Ytterby,",122,4,126,4,349,5050000
Såld 1 september 2022,Tjärnstigen 10,"Lökeberg,",103,5,108,5,1 113,3800000
Såld 1 september 2022,Grepvägen 385,"Ullstorp,",121,29,150,5,388,5710000
Såld 1 september 2022,Lerskärsvägen 13B,"Tjuvkil,",128,4,132,4,1 259,5200000
Såld 31 augusti 2022,Kyrkeby 302,"Harestad,",126,6,132,6,1 097,4900000
Såld 31 augusti 2022,Tvetgatan 143,"Tveten,",93,32,125,5,186,4200000
Såld 29 augusti 2022,Grandalen 230,"Romelanda,",138,6,144,6,1 718,4200000
Såld 29 augusti 2022,Hammarhöjden 700,"Kode,",75,4,79,4,1 123,1650000
Såld 27 augusti 2022,Holm 241,"Kärna,",5,0,5,5,1 207,5100000
Såld 27 augusti 2022,Torsby 270,"Kärna,",161,174,335,8,1 915,5735000
Såld 26 augusti 2022,Lerskärsvägen 52,"Tjuvkil,",106,49,155,4,1 385,5520000
Såld 24 augusti 2022,Korsgatan 3,"Marstrand,",116,30,146,4,494,9200000
Såld 21 augusti 2022,Blekeliden 6,"Västra Gatan,",161,47,208,5,629,7300000
Såld 19 augusti 2022,Rörtången 273,"Rörtången/ödsmålsmosse,",65,2,67,2,629,4100000
Såld 12 augusti 2022,Råckeröd 180,"Kärna,",90,4,94,4,3 183,2050000
Såld 11 augusti 2022,Krokebäcksvägen 85,"Kareby,",123,5,128,5,226,5100000
Såld 4 augusti 2022,Guddeby 210,"Ytterby,",120,120,240,7,3 512,4600000
Såld 4 augusti 2022,Hallbjörtorp 330,"Kärna,",99,4,103,4,2 733,2600000
Såld 20 juli 2022,Glöskär 875,"Kärna,",110,5,115,5,1 615,6775000
Såld 18 juli 2022,Stora Risby 400,"Hålta,",74,68,142,6,1 078,4500000
Såld 15 juli 2022,Hemmansgatan 7,"Ytterby,",155,42,197,6,875,5100000
Såld 15 juli 2022,Hemvägen 7,"Romelanda,",105,33,138,5,437,3750000
Såld 13 juli 2022,Ulvesund 296,"Ytterby,",169,5,174,5,2 567,8800000
Såld 10 juli 2022,Torsby 250,"Kärna,",170,60,230,7,1 810,6525000
Såld 9 juli 2022,Åkerhög 340,"Kärna,",45,3,48,3,1 527,2500000
Såld 5 juli 2022,Rondan 13,"Kungälv - Ödsmålsmosse,",102,55,157,5,1 380,4650000
Såld 3 juli 2022,Blåsippegatan 12,"Kungälv - Ytterby,",115,5,120,5,569,3850000
Såld 28 juni 2022,Bergsvägen 4,"Ödsmålsmosse,",88,15,103,2,783,3995000
Såld 28 juni 2022,Veneröd 439,"Hålta,",118,3,121,3,8 133,3680000
Såld 27 juni 2022,Lefstadvägen 31,"Kärna,",130,5,135,5,881,5050000
Såld 27 juni 2022,Silvergnejsvägen 18,"Kungälv - Gullbringa,",179,5,184,5,2 120,5800000
Såld 27 juni 2022,Östra gatan 9,"Gamla Kungälv,",325,81,406,10,852,10500000
Såld 25 juni 2022,Apelvägen 10,"Diseröd,",104,4,108,4,486,3275000
Såld 23 juni 2022,Dösebacka 110,"Romelanda,",144,79,223,6,5 634,5780000
Såld 22 juni 2022,Lerskärsvägen 18,"Tjuvkil,",65,65,130,5,1 216,3995000
Såld 22 juni 2022,Halltorpsvägen 11,"Kode,",107,13,120,4,1 119,4800000
Såld 21 juni 2022,Duvesjön 351,"Romelanda,",50,35,85,2,2 418,1750000
Såld 21 juni 2022,Kärnavägen 50,"Bohuslän,",128,0,128,,525,3200000
Såld 21 juni 2022,Idrottsgatan 14,"Marstrand,",114,60,174,,592,7800000
Såld 20 juni 2022,Äslingsvägen 10,"Tjuvkil,",75,43,118,4,1 355,4150000
Såld 19 juni 2022,Solberg 450,"Bohuslän,",158,6,164,6,5 435,5250000
Såld 17 juni 2022,Almvägen 9,"Romelanda,",129,10,139,6,803,5260000
Såld 17 juni 2022,Flateby 525,"Bohuslän,",154,6,160,6,2 814,6275000
Såld 16 juni 2022,Korpedalsvägen 9,"Aröd,",47,4,51,4,1 317,3350000
Såld 15 juni 2022,Östergårdsgatan 23,"Ytterby,",180,48,228,6,840,5600000
Såld 15 juni 2022,Åsleröd 130,"Bohuslän,",120,35,155,4,1 566,4700000
Såld 13 juni 2022,Rävo 131,"Bohuslän,",140,5,145,5,3 380,7450000
Såld 11 juni 2022,Situlagatan 4,"Ytterby - Stället,",138,27,165,5,636,6620000
Såld 9 juni 2022,Duvesjön 373,"Duvesjön,",149,9,158,5,1 604,4900000
Såld 9 juni 2022,Odlingsgatan 78,"Ytterby,",130,5,135,5,295,5600000
Såld 8 juni 2022,Östra gatan 29,"Kungälv,",192,128,320,8,384,8300000
Såld 6 juni 2022,Duvesjön 369,"Kungälv -Duvesjön,",4,0,4,4,1 198,5050000
Såld 4 juni 2022,Tjuvkils huvud 918,"Tjuvkil,",60,4,64,4,1 376,5150000
Såld 3 juni 2022,Bergåsvägen 10B,"Ytterby,",115,78,193,6,834,5700000
Såld 31 maj 2022,Lagvägen 29,"Ytterby,",101,4,105,4,713,4700000
Såld 31 maj 2022,Lerskärsvägen 49,"Tjuvkil,",189,6,195,6,1 133,7100000
Såld 29 maj 2022,Sagagatan 6,"Centralt vid älven,",280,45,325,6,768,8500000
Såld 27 maj 2022,Glose 120,"Glose,",64,64,128,4,1 418,3500000
Såld 26 maj 2022,Toreby 240,"Kärna,",89,89,178,4,1 245,3895000
Såld 26 maj 2022,Tronnum 370,"Kärna,",165,36,201,5,2 407,6360000
Såld 23 maj 2022,Ängsgatan 9,"Centrum,",165,16,181,6,575,5700000
Såld 22 maj 2022,Storskiftegatan 35,"Övre Tega,",84,11,95,3,255,4000000
Såld 20 maj 2022,Lerskärsvägen 36,"Tjuvkil,",75,0,75,,1 156,3800000
Såld 17 maj 2022,Rörstigen 8,"Centralt vid älven,",129,2,131,5,407,6200000
Såld 16 maj 2022,Bäckvägen 2,"Kungälv - Lökeberg,",95,48,143,3,1 050,6300000
Såld 16 maj 2022,Hagtornsvägen 1,"Diseröd,",120,107,227,7,788,4650000
Såld 16 maj 2022,Ulvesund 403,"Ytterby,",42,0,42,,287,2400000
Såld 16 maj 2022,Glose 360,"Bohuslän,",75,4,79,4,2 280,3250000
Såld 15 maj 2022,Skålgropsgatan 16,"Ytterby,",120,5,125,5,249,4800000
Såld 14 maj 2022,Fredrik Bagges gata 9,"Koön, Marstrand,",135,6,141,6,979,9500000
Såld 13 maj 2022,Åsebyberg 870,"Åsebyberg,",117,72,189,4,2 667,4900000
Såld 12 maj 2022,Aspvägen 8,"Ytterby,",130,90,220,5,602,6210000
Såld 11 maj 2022,Hällristningsgatan 12,"Ytterby,",107,0,107,,560,5275000
Såld 9 maj 2022,Klockarvägen 4,"Romelanda,",154,6,160,6,561,5000000
Såld 8 maj 2022,Sjöhåla strandväg 36,"Kovikshamn,",179,6,185,6,1 720,6900000
Såld 6 maj 2022,Duvesjön 304,"Kungälv,",124,4,128,4,1 180,5600000
Såld 3 maj 2022,Holm 280,"Kärna,",65,3,68,3,1 893,3300000
Såld 29 april 2022,Bräcke 220,"Kärna,",120,6,126,6,1 565,5250000
Såld 28 april 2022,Sundhammarsvägen 790,"Kovikshamn/Sundhammar,",78,3,81,3,1 156,3625000
Såld 27 april 2022,Vävra 433,"Hålta,",198,6,204,6,1 729,6275000
Såld 27 april 2022,Grepvägen 393,"Ullstorp,",148,5,153,5,477,7000000
Såld 27 april 2022,Torsbyvägen 50,"Ytterby,",101,49,150,4,4 904,5550000
Såld 26 april 2022,Dösebacka 150,"Romelanda,",95,2,97,2,1 600,4950000
Såld 25 april 2022,Åsebyberg 855,"Åsebyberg,",129,18,147,5,4 105,5000000
Såld 25 april 2022,Lingonvägen 16,"Centralt,",134,5,139,5,381,5800000
Såld 24 april 2022,Staby 375,"Kärna,",129,6,135,6,1 558,5400000
Såld 24 april 2022,Granvägen 7,"Ytterby,",100,54,154,4,623,5300000
Såld 22 april 2022,Årsnäs 460,"Kungälv - Årsnäs,",40,3,43,3,2 393,3600000
Såld 16 april 2022,Trankärr 223,"Trankärr,",6,0,6,6,958,5850000
Såld 14 april 2022,Marieberg 210,"Kungälv,",120,34,154,5,3 245,3150000
Såld 14 april 2022,Dotorp 260,"Kungälv - Kärna,",162,9,171,6,2 003,4775000
Såld 13 april 2022,Högalidsgatan 12,"Centralt vid älven,",139,72,211,7,816,6450000
Såld 13 april 2022,Kodevägen 15,"Kode,",147,123,270,6,1 301,4525000
Såld 13 april 2022,Kungälvsvägen 27,"Grinden,",133,6,139,6,243,4950000
Såld 13 april 2022,Onyxvägen 1,"Kode,",155,7,162,7,818,4400000
Såld 4 april 2022,Kärnavägen 7,"Kärna,",97,133,230,7,786,3995000
Såld 3 april 2022,Åsebyberg 735,"Kode,",158,21,179,5,1 362,6200000
Såld 30 mars 2022,Lagvägen 4,"Ytterby,",129,20,149,5,816,5630000
Såld 30 mars 2022,Marielundsvägen 12,"Koön,",74,3,77,3,854,5400000
Såld 30 mars 2022,Gräsgången 5,"Kungälv,",121,4,125,4,343,4600000
Såld 30 mars 2022,Åsebyberg 883,"Åsebyberg,",96,4,100,4,343,4630000
Såld 25 mars 2022,Åsebyberg 755,"Kode,",75,40,115,3,961,3900000
Såld 25 mars 2022,Västra Strandgatan 3,"Centralt vid älven,",111,61,172,5,650,6000000
Såld 17 mars 2022,Matskärsvägen 6,"Tjuvkil,",155,19,174,7,521,6300000
Såld 16 mars 2022,Prejelvägen 103,"Ullstorp,",106,4,110,4,372,5380000
Såld 15 mars 2022,Vävra 425,"Tjuvkil/ Lycke,",165,50,215,,1 193,7650000
Såld 15 mars 2022,Briljantvägen 30,"Kode,",143,5,148,5,520,5400000
Såld 15 mars 2022,Hallsbergsvägen 12,"Kode,",150,15,165,6,1 639,5800000
Såld 11 mars 2022,Rönnvägen 22,"Romelanda,",108,70,178,6,823,5000000
Såld 10 mars 2022,Galärgatan 8,"Centrum,",119,62,181,5,655,4700000
Såld 10 mars 2022,Bergkristallvägen 3,"Kode,",125,9,134,5,527,5460000
Såld 10 mars 2022,Storskiftegatan 17,"Övre Tega,",111,4,115,4,165,4600000
Såld 9 mars 2022,Dammen 135,"Kode,",90,20,110,4,4 698,3200000
Såld 9 mars 2022,Rondan 19,"Ödsmålsmosse,",60,60,120,4,1 927,5400000
Såld 9 mars 2022,Tvetgatan 289,"Bohuslän,",130,9,139,5,127,4440000
Såld 7 mars 2022,Marias väg 35,"Aröd,",70,3,73,3,1 225,3450000
Såld 6 mars 2022,Thorilds gränd 12,"Centralt,",83,6,89,6,470,8000000
Såld 4 mars 2022,Västra gatan 31,"Gamla Staden,",262,9,271,9,636,8800000
Såld 3 mars 2022,Östergårdsgatan 20,"Ytterby,",133,65,198,6,1 154,5720000
Såld 3 mars 2022,Glose 660,"Kärna,",60,3,63,3,1 703,3330000
Såld 3 mars 2022,Ivar Claessons gata 10,"Kungälv - Centralt,",105,53,158,5,967,5300000
Såld 24 februari 2022,Häljeröd 170,"Romelanda,",102,48,150,4,13 432,5750000
Såld 21 februari 2022,Hallsbergsvägen 7,"Kode,",172,85,257,7,3 363,5450000
Såld 19 februari 2022,Grandalen 200,"Romelanda,",115,21,136,4,1 937,4290000
Såld 18 februari 2022,Fontinvägen 23,"Centralt,",168,75,243,6,1 402,5900000
Såld 17 februari 2022,Lefstadvägen 35,"Kärna,",127,61,188,5,1 255,5700000
Såld 16 februari 2022,Munkegärdegatan 321A,"Munkegärde,",99,0,99,,357,4905000
Såld 14 februari 2022,Åkerhög 394,"Vedhall,",148,4,152,4,1 262,7250000
Såld 12 februari 2022,Åsebyberg 868,"Bohuslän,",154,7,161,7,4 234,6400000
Såld 9 februari 2022,Signehög 360,"Bohuslän,",78,68,146,4,2 771,3825000
Såld 8 februari 2022,Hammarberg 895,"Kode,",67,0,67,,1 997,3360000
Såld 3 februari 2022,Sundhammarsvägen 480,"Kovikshamn/Sundhammar,",167,13,180,5,2 290,6475000
Såld 28 januari 2022,Gamla Kungälvsvägen 9,"Ytterby,",65,88,153,4,1 000,5555000
Såld 28 januari 2022,Murhammarvägen 17,"Kareby,",168,6,174,6,2 496,7300000
Såld 27 januari 2022,Mjölnarvägen 3,"Diseröd,",137,5,142,5,534,4500000
Såld 26 januari 2022,Häroldsgatan 5,"Centrum,",141,7,148,7,799,5700000
Såld 25 januari 2022,Långåkersgatan 6,"Centralt,",140,36,176,5,733,7000000
Såld 24 januari 2022,Västerhöjdsvägen 111,"Kärna,",103,5,108,5,423,2500000
Såld 22 januari 2022,Valtersäng 11,"Trankärr,",162,4,166,4,808,6150000
Såld 21 januari 2022,Skvaltvägen 3,"Diseröd,",180,145,325,8,1 352,5975000
Såld 19 januari 2022,Trätäljagatan 7,"Iskällan,",142,142,284,7,1 037,7550000
Såld 18 januari 2022,Snäckvägen 16,"Rörtången/ödsmålsmosse,",62,2,64,2,1 801,3144000
Såld 18 januari 2022,Hemvägen 21,"Diseröd,",108,32,140,4,384,4050000
Såld 11 januari 2022,Ödsmål 540,"Rörtången,",65,31,96,4,916,3850000
Såld 8 januari 2022,Lagvägen 17,"Ytterby,",164,5,169,5,597,5850000
Såld 7 januari 2022,Mariebergsliden 5,"Öster,",277,91,368,7,589,10000000
Såld 30 december 2021,Älvängen 180,"Harestad,",75,58,133,4,1 631,4150000
Såld 22 december 2021,Mossvägen 24,"Hålta,",72,3,75,3,1 068,3500000
Såld 21 december 2021,Galeasgatan 6,"Komarken,",100,3,103,3,296,4000000
Såld 14 december 2021,Stenåldersgatan 50,"Stället,",110,5,115,5,221,4900000
Såld 9 december 2021,Munkegärdegatan  310,"Munkegärde,",146,6,152,6,622,6110000
Såld 8 december 2021,Stora Ryr 310,"Tjuvkil/ Lycke,",106,55,161,5,1 239,3695000
Såld 7 december 2021,Mårdgatan 11,"Klöverbacken - Olseröd,",166,12,178,5,367,6310000
Såld 6 december 2021,Ulvebackegatan 3,"Ulvegärde,",129,44,173,4,927,4600000
Såld 3 december 2021,Plogvägen 187,"Ullstorp,",122,6,128,5,406,5600000
Såld 3 december 2021,Galärgatan 1,"Centralt vid älven,",104,4,108,4,762,3900000
Såld 1 december 2021,Korpedalsvägen 13,"Aröd/Timmervik,",47,40,87,2,1 179,2850000
Såld 30 november 2021,Grindstolpen 21,"Ytterby,","76,1",3,,3,1 179,3950000
Såld 29 november 2021,Hanekullen 200,"Kareby,",114,4,118,4,1 673,4200000
Såld 28 november 2021,Fontinvägen 13,"Bohuslän,",120,110,230,4,1 167,6960500
Såld 26 november 2021,Kyrkeby 300,"Harestad,",114,117,231,6,1 402,4170000
Såld 25 november 2021,Parkgatan 21,"Marstrand - Koön,",113,76,189,7,592,6100000
Såld 25 november 2021,Bäckgatan 38,"Centrum,",108,60,168,7,607,6670000
Såld 23 november 2021,Bärtas väg 7,"Kode,",53,2,55,2,1 792,2950000
Såld 18 november 2021,Lundby 380,"Kareby,",140,0,140,,1 818,5200000
Såld 17 november 2021,Nygatan 36,"Marstrand,",118,30,148,4,146,5900000
Såld 17 november 2021,Hammarberg 840,"Kode,",82,14,96,3,1 893,3420000
Såld 16 november 2021,Duvesjön 360,"Duvesjön,","109,6",4,,4,968,4600000
Såld 15 november 2021,Vallgatan 3,"Kungälv - Centralt,",65,61,126,5,495,5800000
Såld 12 november 2021,Vallby 210,"Kode,",70,3,73,3,1 260,2550000
Såld 12 november 2021,Dotorp 470,"Kärna,",127,4,131,4,18 448,6495000
Såld 11 november 2021,Prästvägen,"Bohuslän,",,,0,,24 755,1725000
Såld 10 november 2021,Bremnäs 400,"Lycke,",130,4,134,4,2 562,5800000
Såld 10 november 2021,Hammarhöjden 680,"Kode,",100,5,105,5,1 059,3650000
Såld 5 november 2021,Stenhålt 124,"Romelanda,",163,7,170,7,1 668,5600000
Såld 4 november 2021,Veneröd 430,"Hålta,",92,4,96,4,1 376,3825000
Såld 4 november 2021,Poppelvägen 1,"Diseröd,",138,5,143,5,788,4300000
Såld 3 november 2021,Hammarhöjden 695,"Kode,",92,3,95,3,1 053,3600000
Såld 3 november 2021,Grindklykan 7,"Grinden,",114,7,121,4,392,5095000
Såld 30 oktober 2021,Oxelvägen 24,"Diseröd,",139,6,145,6,404,4000000
Såld 30 oktober 2021,Granliden 9,"Vedhall,",181,25,206,5,678,9550000
Såld 29 oktober 2021,Dalen 150,"Kärna,",154,6,160,6,1 052,5065000
Såld 28 oktober 2021,Östra gatan 43,"Bohuslän,",134,31,165,5,"1 403,6",5600000
Såld 27 oktober 2021,Hamngatan 1,"Centralt vid älven,",136,83,219,6,617,6010000
Såld 26 oktober 2021,Kaprifolvägen 6,"Kärna,",128,5,133,5,524,4800000
Såld 26 oktober 2021,Olserödsgatan 16,"Olseröd,",118,5,123,5,238,4300000
Såld 20 oktober 2021,Lundby 330,"Kungälv - Kareby,",123,33,156,4,1 870,4175000
Såld 20 oktober 2021,Tega 190,"Ytterby,",223,129,352,9,1 154,4500000
Såld 19 oktober 2021,Prästvägen 721,"Diseröd,",210,60,270,7,1 096,5900000
Såld 14 oktober 2021,Guntorpsvägen 12,"Kode,",139,70,209,8,1 039,4130000
Såld 13 oktober 2021,Vetegången 15,"Centrum,",124,4,128,4,403,4800000
Såld 12 oktober 2021,Vävra 470,"Hålta,",160,10,170,5,3 244,3750000
Såld 6 oktober 2021,Källeröd 140,"Kareby,",103,143,246,7,1 769,6000000
Såld 6 oktober 2021,Lingonvägen 24,"Munkegärde,",142,6,148,6,334,5650000
Såld 6 oktober 2021,Rishammarvägen 14,"Kareby,",168,84,252,5,795,6500000
Såld 1 oktober 2021,Tyftervägen 30,"Diseröd,",61,40,101,6,1 683,2700000
Såld 1 oktober 2021,Västra Strandgatan 1,"Kungälv - Centrum,",120,58,178,6,640,6175000
Såld 1 oktober 2021,Bremnäs 520,"Lycke,",44,3,47,3,3 048,2675000
Såld 30 september 2021,Halleravägen 2,"Kärna,",83,4,87,4,1 183,5561000
Såld 30 september 2021,Prästvägen 395,"Kareby,",212,6,218,6,4 712,7200000
Såld 30 september 2021,Holmängen 150,"Kärna,",117,60,177,4,1 276,5400000
Såld 29 september 2021,Broberg 190,"Kungälv - Lycke,",67,4,71,4,1 755,2075000
Såld 27 september 2021,Hallbjörtorp 500,"Kärna,",162,6,168,6,2 752,6150000
Såld 25 september 2021,Bokvägen 5,"Centrum,",89,89,178,5,636,6800000
Såld 24 september 2021,Byvägen 38,"Rörtången/ödsmålsmosse,",30,"1,5",,"1,5",1 266,2680000
Såld 24 september 2021,Safirvägen 5,"Kode,",187,7,194,7,765,4720000
Såld 21 september 2021,Skårby 590,"Kareby,",107,10,117,4,1 132,4300000
Såld 20 september 2021,Skårby station 470,"Kungälv - Kareby,",35,2,37,2,1 501,1250000
Såld 17 september 2021,Älggatan 20,"Klöverbacken - Olseröd,",95,4,99,4,1 501,4120000
Såld 16 september 2021,Målardalen 210,"Kode,",130,26,156,9,3 056,3325000
Såld 16 september 2021,Ingegatan 6R,"Komarken,",149,71,220,7,152,5000000
Såld 16 september 2021,Häljeröd 385,"Romelanda,",201,5,206,5,2 639,5825000
Såld 15 september 2021,Halleravägen 17,"Kovikshamn,",74,18,92,4,1 215,5110000
Såld 14 september 2021,Skolstigen 4,"Kungälv - Centralt,",174,74,248,7,763,6700000
Såld 13 september 2021,Toreby 390,"Harestad-Toreby,",115,78,193,5,1 819,4720000
Såld 11 september 2021,Skårby station 520,"Kareby,",124,37,161,5,1 060,4445000
Såld 8 september 2021,Kulperödsvägen 39,"Hålta,",129,4,133,4,1 192,2800000
Såld 8 september 2021,Kastellegårdsvägen 240,"Kastellegården,",108,55,163,4,1 391,4210000
Såld 8 september 2021,Kareby kyrkväg 320,"Bohuslän,",110,80,190,5,1 395,4725000
Såld 6 september 2021,Munkegärdegatan 231,"Munkegärde,",155,40,195,6,726,6190000
Såld 6 september 2021,Lievägen 226,"Kungälv,",149,5,154,5,392,6400000
Såld 5 september 2021,Betesgatan 14,"Ytterby,",170,10,180,6,752,7475000
Såld 3 september 2021,Broberg 130,"Lycke,",133,5,138,5,2 400,4995000
Såld 2 september 2021,Matskärsvägen 36,"Tjuvkil,",60,3,63,3,1 077,3125000
Såld 2 september 2021,Hermansby 150,"Kärna,",110,110,220,6,2 397,5600000
Såld 1 september 2021,Torsbyvägen 10F,"Ytterby,",126,5,131,5,234,3470000
Såld 1 september 2021,Poppelvägen 3,"Diseröd,",106,48,154,5,800,4600000
Såld 31 augusti 2021,Kärrhed 177,"Kärna,",150,7,157,7,1 429,5550000
Såld 30 augusti 2021,Domsvägen 5,"Ytterby,",95,45,140,6,1 043,5775000
Såld 27 augusti 2021,Ulvesund 414,"Hisingen,",44,0,44,,744,1625000
Såld 27 augusti 2021,Älggatan 16,"Klöverbacken - Olseröd,",122,21,143,6,744,4375000
Såld 27 augusti 2021,Kungälvsvägen 60,"Kungälv - Centralt,",102,4,106,4,1 114,3650000
Såld 25 augusti 2021,Olserödsgatan 116,"Olseröd,",150,34,184,5,725,6150000
Såld 25 augusti 2021,Lefstad 370,"Kärna,",105,64,169,5,1 759,6100000
Såld 24 augusti 2021,Tjuvkil 310,"Tjuvkil,",85,3,88,3,1 027,3800000
Såld 22 augusti 2021,Fontinvägen 16,"Bohuslän,",135,35,170,6,1 012,6125000
Såld 21 augusti 2021,Västra gatan 6,"Bohuslän,",326,231,557,12,693,11000000
Såld 20 augusti 2021,Kuskalundsvägen 36,"HÅLTA,",138,23,161,6,1 339,4100000
Såld 19 augusti 2021,Gömmet 120,"Romelanda,",197,19,216,5,2 800,5250000
Såld 16 augusti 2021,Gunneröd 200,"Kärna,",40,10,50,3,789,2490000
Såld 16 augusti 2021,Ödsmål 360,"Ödsmål,",105,66,171,6,794,4700000
Såld 10 augusti 2021,Lagvägen 41,"Ytterby,",161,5,166,5,642,5035000
Såld 10 augusti 2021,Metesten 150,"Harestad,",131,19,150,5,1 507,4300000
Såld 9 augusti 2021,Sjöhåla 580,"Kärna,",94,87,181,5,1 068,3490000
Såld 9 augusti 2021,Duvesjön 215,"Romelanda,",90,3,93,3,1 113,2750000
Såld 6 augusti 2021,Plogvägen 168,"Ullstorp,",122,5,127,5,299,5800000
Såld 6 augusti 2021,Sjöhåla 380,"Holmängen,",71,12,83,,1 527,2175000
Såld 4 augusti 2021,Munkholmsgatan 8,"Kungälv - Centralt,",120,60,180,7,639,6100000
Såld 2 augusti 2021,Hallsbrovägen 14,"Kärna,",145,61,206,5,2 108,4500000
Såld 29 juli 2021,Väktaregatan 9,"Centralt,",166,83,249,9,538,6900000
Såld 23 juli 2021,Rådmansgatan 11,"Kungälv Centralt,",167,122,289,6,547,6800000
Såld 21 juli 2021,Flateby 470,"Harestad,",61,7,68,3,1 409,2800000
Såld 20 juli 2021,Rondan 20,"Ödsmålsmosse,",82,75,157,4,1 326,3900000
Såld 15 juli 2021,Olserödsgatan 10,"Olseröd,",118,5,123,5,285,4700000
Såld 13 juli 2021,Nereby 370,"Hisingen,",65,3,68,3,1 840,3550000
Såld 13 juli 2021,Bergåsvägen 26,"Ytterby,",184,55,239,4,891,6450000
Såld 12 juli 2021,Gömmet 130,"Romelanda,",160,7,167,7,3 055,4900000
Såld 12 juli 2021,Alvägen 5,"Bohuslän,",127,5,132,5,744,4550000
Såld 10 juli 2021,Olserödsgatan 118,"Olseröd,",127,24,151,6,910,6200000
Såld 9 juli 2021,Gömmet 110,"Romelanda,",153,24,177,3,30 000,5600000
Såld 8 juli 2021,Olsåker 110,"Kareby,",139,60,199,6,16 226,5900000
Såld 8 juli 2021,Källeröd 192,"Kareby,",141,6,147,6,1 335,5295000
Såld 6 juli 2021,Olvonvägen 17,"Diseröd,",162,17,179,7,683,5300000
Såld 5 juli 2021,Bäckvägen 8,"Lökeberg,",85,43,128,4,1 016,2750000
Såld 3 juli 2021,Rävsal 170,"Olseröd,",124,50,174,5,2 514,3525000
Såld 29 juni 2021,Ön 150,"Kareby,",127,5,132,5,2 077,5750000
Såld 28 juni 2021,Klintegatan 8,"Kungälv - Centralt,",130,80,210,7,778,7100000
Såld 24 juni 2021,Marias väg 17,"Aröd,",99,34,133,4,1 318,4700000
Såld 24 juni 2021,Skårby station 130,"Kareby,",89,96,185,4,1 686,2600000
Såld 22 juni 2021,Lilla Ryr 170,"Lycke,",40,9,49,2,1 345,2900000
Såld 22 juni 2021,Prästvägen 450,"Kareby,",116,50,166,4,2 572,4600000
Såld 21 juni 2021,Olserödsgatan 90,"Klöverbacken - Olseröd,",108,4,112,4,223,3600000
Såld 21 juni 2021,Ekliden 8,"Centralt,",67,66,133,3,1 041,5000000
Såld 19 juni 2021,Vedhall 120,"Kärna,",88,49,137,4,2 105,6500000
Såld 18 juni 2021,Toreby 200,"Bohuslän,",103,130,233,4,2 391,4100000
Såld 18 juni 2021,Holm 285,"Kärna,",6,0,6,6,1 091,4300000
Såld 17 juni 2021,Häljeröd 300,"Kungälv - Romelanda,",223,25,248,7,3 547,6900000
Såld 15 juni 2021,Konvaljgatan 10,"Ytterby,",115,4,119,4,634,5050000
Såld 15 juni 2021,Skutviksvägen 3,"Marstrand - Instön,",42,3,45,3,1 223,4750000
Såld 14 juni 2021,Harkvägen 349,"Kungälv - Ullstorp,",126,4,130,4,1 223,4900000
Såld 11 juni 2021,Dotorp 540,"Kärna,",120,5,125,5,1 214,3900000
Såld 11 juni 2021,Otterlyckan 49,"Instön,",63,4,67,4,769,4900000
Såld 11 juni 2021,Duvesjön 475,"Diseröd,",36,3,39,3,1 577,1825000
Såld 10 juni 2021,Helgonagatan 157,"Munkegärde,",109,109,218,7,903,5025000
Såld 9 juni 2021,Dannemarksgatan 14,"Ytterby-Tega,",210,86,296,8,1 203,6250000
Såld 8 juni 2021,Flateby 360,"Kungälv - Harestad,",125,95,220,7,1 726,3100000
Såld 7 juni 2021,Västra Röd 350,"Harestad,",83,3,86,3,1 637,3550000
Såld 4 juni 2021,Lievägen 237,"Ullstorp,",140,19,159,5,507,6200000
Såld 4 juni 2021,Häradsvägen 20,"Ytterby,",130,5,135,5,342,4850000
Såld 3 juni 2021,Enekullsvägen 54B,"Ytterby,",176,6,182,6,930,5600000
Såld 3 juni 2021,Truskärsvägen 16,"Tjuvkil,",165,6,171,6,1 143,7400000
Såld 3 juni 2021,Signehög 332,"Romelanda,",126,6,132,6,1 459,4500000
Såld 3 juni 2021,Skårby station 550,"Kungälv - Kareby,",96,90,186,6,1 087,3450000
Såld 2 juni 2021,Kvarnvägen 28,"Ingetorp,",140,3,143,3,1 272,5400000
Såld 2 juni 2021,Livelycke 140,"Kungälv,",109,5,114,5,2 888,4000000
Såld 2 juni 2021,Skårshöjd 8,"Kärna,",140,40,180,5,921,4425000
Såld 2 juni 2021,Ametistvägen 5,"Kode,",98,95,193,5,780,4900000
Såld 2 juni 2021,Prejelvägen 139,"Ullstorp,",122,5,127,5,604,5800000
Såld 28 maj 2021,Hermansby 190,"Kärna,",115,6,121,6,2 488,4850000
Såld 28 maj 2021,Signehög 150,"Romelanda,",130,130,260,6,2 151,2200000
Såld 25 maj 2021,Marias väg 35,"Aröd,",45,3,48,3,1 225,1130000
Såld 25 maj 2021,Hamngatan 13,"Centralt vid älven,",64,60,124,4,645,4900000
Såld 25 maj 2021,Guddeby 274,"Ytterby,",159,55,214,7,1 527,6500000
Såld 21 maj 2021,Skårby mosse 872,"Kareby,",160,6,166,6,2 663,7200000
Såld 21 maj 2021,Hermansby 224,"Kärna,",178,6,184,6,1 494,7200000
Såld 19 maj 2021,Parkgatan 18,"Marstrand - Koön,",160,30,190,6,562,9400000
Såld 19 maj 2021,Lyckevägen 5B,"Kärna,",95,61,156,3,673,4400000
Såld 19 maj 2021,Saltskärsvägen 10,"Kungälv - Lycke,",64,3,67,3,3 440,3125000
Såld 18 maj 2021,Stora Risby 480,"Hålta,",108,26,134,5,941,4950000
Såld 18 maj 2021,Harkvägen 323,"Kungälv - Ullstorp,",126,4,130,4,941,4705000
Såld 18 maj 2021,Grepvägen 385,"Ullstorp,",121,29,150,5,388,5640000
Såld 17 maj 2021,Fridhemsgatan 9,"Centralt,",137,90,227,6,850,6525000
Såld 17 maj 2021,Lökebergsvägen 43,"Lökeberg,",120,54,174,4,3 364,4825000
Såld 16 maj 2021,Häljeröd 210,"Romelanda,",160,35,195,4,1 690,3550000
Såld 14 maj 2021,Vegestorp 210,"Kareby,",98,98,196,5,1 610,4125000
Såld 12 maj 2021,Olvonvägen 27,"Diseröd,",123,97,220,6,682,5150000
Såld 11 maj 2021,Storskiftegatan 55,"Ytterby,",131,46,177,5,835,6550000
Såld 11 maj 2021,Skårby station 540,"Kareby,",57,0,57,,1 090,1200000
Såld 11 maj 2021,Almvägen 21,"Diseröd,",158,8,166,8,1 130,5300000
Såld 10 maj 2021,Glose 630,"Kärna,",96,17,113,3,1 187,4150000
Såld 10 maj 2021,Lerlycke 240,"Kärna,",135,44,179,3,9 078,6000000
Såld 8 maj 2021,Bergkristallvägen 5,"Kode,",126,9,135,5,477,5000000
Såld 7 maj 2021,Veneröd 640,"Hålta,",70,0,70,,4 606,820000
Såld 7 maj 2021,Lundby 502,"Kareby,",137,4,141,4,2 174,5700000
Såld 7 maj 2021,Hällristningsgatan 18,"Ytterby - Stället,",103,9,112,4,281,4650000
Såld 5 maj 2021,Hareslättsvägen 8,"Marstrand,",188,30,218,6,676,8800000
Såld 5 maj 2021,Sundviksvägen 39,"Tjuvkil,",117,5,122,5,447,6300000
Såld 5 maj 2021,Prejelvägen 109,"Ullstorp,",122,12,134,5,432,5640000
Såld 29 april 2021,Holm 220,"Bohuslän,",175,93,268,7,479 907,10000000
Såld 29 april 2021,Mycklaborgsgatan 3,"Centrum,",149,20,169,5,684,5100000
Såld 29 april 2021,Östra gatan 34,"Bohuslän,",208,49,257,8,2 419,6000000
Såld 28 april 2021,Bastubäcksvägen 33,"Ödsmålsmosse,",85,4,89,4,1 205,4175000
Såld 26 april 2021,Ulvebackegatan 20,"Ulvegärde,",196,30,226,6,766,6500000
Såld 25 april 2021,Gårdskiftegatan 67,"Ytterby,",103,34,137,4,780,5000000
Såld 21 april 2021,Enekullsvägen 52B,"Ytterby,",185,6,191,6,795,6400000
Såld 20 april 2021,Gulskärsvägen 21,"Tjuvkil,",149,14,163,6,1 512,7400000
Såld 20 april 2021,Mårdgatan 4,"Olseröd,",124,45,169,5,1 122,7150000
Såld 19 april 2021,Lilla Fjellsholmen 22,"Lilla Fjellsholmen,",4,0,4,4,406,8900000
Såld 16 april 2021,Lindvägen 8,"Ytterby,",244,72,316,7,1 330,7700000
Såld 16 april 2021,Stenåldersgatan 41,"Ytterby,",120,5,125,5,404,5350000
Såld 16 april 2021,Harkvägen 335,"Ullstorp,",131,4,135,4,404,4610000
Såld 15 april 2021,Prästvägen 296,"Kareby,",187,6,193,6,1 434,8100000
Såld 15 april 2021,Duvesjön 228,"Diseröd,",121,37,158,5,1 150,4925000
Såld 15 april 2021,Kuskalundsvägen 11,"Hålta,",110,49,159,3,1 227,4025000
Såld 14 april 2021,Ulvesund 412,"Ulvesund,",106,9,115,4,806,4750000
Såld 13 april 2021,Mantalsgatan 15,"Tega,",110,4,114,4,986,3725000
Såld 13 april 2021,Klintegatan 7,"Kungälv - Centrum,",143,112,255,5,798,7750000
Såld 12 april 2021,Duvesjön 205,"Diseröd,",126,4,130,4,1 062,4700000
Såld 8 april 2021,Nygatan 6,"Marstrand - Koön,",90,4,94,4,376,7500000
Såld 8 april 2021,Prästvägen 170,"Kareby,",95,140,235,7,2 868,3770000
Såld 4 april 2021,Hammarberg 825,"Kode,",65,74,139,5,3 030,4350000
Såld 2 april 2021,Duvesjön 420,"Bohuslän,",127,10,137,5,834,5400000
Såld 1 april 2021,Rönnvägen 11,"Diseröd,",120,88,208,6,849,3465000
Såld 1 april 2021,Toreby mosse 570,"Ytterby,",110,80,190,8,1 375,2980000
Såld 1 april 2021,Häljeröd 106,"Diseröd,",120,90,210,8,1 734,3700000
Såld 26 mars 2021,Domsvägen 7B,"Centralt Ytterby,",159,62,221,6,600,5500000
Såld 25 mars 2021,Grandalen 110,"Duvesjön,",65,2,67,2,1 121,2375000
Såld 25 mars 2021,Kroken 142,"Harestad,",,,0,,1 175,3900000
Såld 23 mars 2021,Ekvägen 2,"Ytterby,",177,60,237,7,769,7700000
Såld 22 mars 2021,Råckeröd 140,"Kärna,",66,20,86,3,2 269,3800000
Såld 19 mars 2021,Nätstigen 7,"Centralt,",120,4,124,4,299,3900000
Såld 18 mars 2021,Hallbjörtorp 492,"Kärna,",104,8,112,3,1 499,3900000
Såld 18 mars 2021,Dösebacka 130,"Diseröd,",123,41,164,6,4 859,5350000
Såld 17 mars 2021,Åsgatan 17A,"Centrum,",84,44,128,4,903,5620000
Såld 17 mars 2021,Tvetgatan 263,"Tveten,",100,50,150,6,138,3850000
Såld 16 mars 2021,Olserödsgatan 86,"Kungälv - Olseröd,",104,5,109,5,288,4050000
Såld 16 mars 2021,Tjuvkil 450,"Tjuvkil,",237,118,355,8,1 434,3120000
Såld 16 mars 2021,Rondan 19,"Rörtången / Ödsmålsmosse,",60,60,120,4,1 927,4400000
Såld 16 mars 2021,Åsebyberg 960,"Kode,",157,16,173,5,1 038,3850000
Såld 16 mars 2021,Ulvegärdegatan 15,"Ulvegärde,",140,96,236,7,1 438,6100000
Såld 15 mars 2021,Solhultsgatan 27,"Komarken,",100,4,104,4,560,3315000
Såld 12 mars 2021,Flateby 480,"Harestad,",59,16,75,3,1 194,1600000
Såld 11 mars 2021,Björkebacka 114,"Kareby,",104,5,109,5,996,5100000
Såld 10 mars 2021,Älvängen 130,"Harestad,",317,71,388,10,1 180,5250000
Såld 3 mars 2021,Tegskiftegatan 46,"Ytterby,",184,54,238,8,865,6850000
Såld 2 mars 2021,Sjöhåla strandväg 12,"Kärna,",99,4,103,4,1 441,4350000
Såld 27 februari 2021,Skardet 120,"Kode,",141,6,147,6,2 086,5300000
Såld 27 februari 2021,Granliden 11,"Vedhall,",253,"23,5",,5,578,9200000
Såld 25 februari 2021,Önneröd 220,"Kärna,",112,4,116,4,25 370,3000000
Såld 24 februari 2021,Duvesjön 232,"Duvesjön,",122,5,127,5,1 076,4725000
Såld 22 februari 2021,Annas väg 4,"Kärna,",102,7,109,4,1 158,3700000
Såld 18 februari 2021,Madängsgatan 13,"Centrum,",154,18,172,7,740,5750000
Såld 15 februari 2021,Bokvägen 12,"Fontin,",175,35,210,6,635,7400000
Såld 12 februari 2021,Tullaregatan 3,"Marstrandsön,",160,5,165,5,333,15800000
Såld 11 februari 2021,Ulvegärdegatan 15B,"Ulvegärde,",80,4,84,4,914,3700000
Såld 10 februari 2021,Guddeby 174,"Ytterby / Guddeby,",143,6,149,6,1 257,5475000
Såld 9 februari 2021,Gamla Trollhättevägen 6,"Centralt,",210,170,380,8,1 368,7600000
Såld 8 februari 2021,Lybeck 151,"Diseröd,",117,40,157,4,1 572,5120000
Såld 5 februari 2021,Furuvägen 8,"Diseröd,",102,102,204,4,715,3100000
Såld 4 februari 2021,Barlinds Väg 4B,"Instön,",80,25,105,4,715,7900000
Såld 3 februari 2021,Settungsvägen 48,"Ullstorp,",123,22,145,4,543,5935000
Såld 3 februari 2021,Toftebergsvägen 2,"Tjuvkil,",85,6,91,"3,5",1 085,3895000
Såld 31 januari 2021,Skårshöjd 6,"Kärna,",107,3,110,3,909,4575000
Såld 29 januari 2021,Lyckevägen 5C,"Kärna,",95,61,156,3,1 060,4500000
Såld 28 januari 2021,Odlingsgatan 88,"Ytterby,",130,5,135,5,464,5275000
Såld 28 januari 2021,Rishammarvägen 2,"Kareby,",155,62,217,8,2 086,6770000
Såld 28 januari 2021,Lerlycke 210,"Kärna,",148,5,153,5,925,4030000
Såld 27 januari 2021,Näckrosvägen 7A,"Kärna,",140,5,145,5,1 321,6650000
Såld 27 januari 2021,Lilla Fjellsholmen 11,"Lilla Fjellsholmen,",103,5,108,5,414,8700000
Såld 26 januari 2021,Åsebyberg 655,"Åsebyberg,",35,2,37,2,2 854,2700000
Såld 24 januari 2021,Håkons gata 2,"Centrum,",124,124,248,6,1 006,5350000
Såld 23 januari 2021,Beryllvägen 11,"Kode,",123,5,128,5,350,3650000
Såld 22 januari 2021,Glöskär 390,"Kärna,",170,5,175,5,2 171,5100000
Såld 21 januari 2021,Täljstensgatan 4,"Ytterby,",70,12,82,3,478,3600000
Såld 19 januari 2021,Glose 650,"Bohuslän,",75,0,75,,3 702,2950000
Såld 18 januari 2021,Bärtas väg 10,"Ödsmålsmosse,",30,2,32,2,1 525,1600000
Såld 13 januari 2021,Kantorvägen 3,"Bohuslän,",165,14,179,5,761,4625000
Såld 12 januari 2021,Holm 160,"Kärna,",143,108,251,5,3 125,4525000
Såld 11 januari 2021,Högsberg 355,"Kode,",98,4,102,4,1 797,3825000
Såld 7 januari 2021,Skårby station 215,"Kareby,",95,88,183,5,1 498,3700000
Såld 23 december 2020,Signehög 240,"Signehög,",121,77,198,3,1 498,2500000
Såld 21 december 2020,Munkegärdegatan 253,"Kungälv Munkegärde,",134,110,244,8,899,6060000
Såld 18 december 2020,Klintegatan 21,"Kungälv,",90,3,93,3,672,3800000
Såld 16 december 2020,Prästvägen 788,"Bohuslän,",175,8,183,8,1 456,6150000
Såld 12 december 2020,Almvägen 19,"Bohuslän,",162,4,166,4,801,5325000
Såld 9 december 2020,Oxelvägen 80,"Diseröd,",139,20,159,7,751,5475000
Såld 8 december 2020,Byvägen 42,"Kode,",54,0,54,,1 521,1750000
Såld 4 december 2020,Källeröd 193,"Kareby,",126,6,132,6,1 163,4495000
Såld 2 december 2020,Ulvesund 415,"Ytterby,",48,3,51,3,791,2060000
Såld 2 december 2020,Bollestad 130,"Kareby,",145,55,200,6,1 554,3975000
Såld 1 december 2020,Klockarvägen 6,"Bohuslän,",137,5,142,5,561,4450000
Såld 1 december 2020,Västerhöjdsvägen 36,"Kärna,",107,4,111,4,258,4425000
Såld 30 november 2020,Sjöstigen 7,"Kungälv,",115,5,120,5,289,3400000
Såld 30 november 2020,Alekärr 125,"Romelanda,",120,4,124,4,1 950,5600000
Såld 30 november 2020,Rörmossevägen 170,"Kungälv,",214,8,222,8,2 864,4950000
Såld 29 november 2020,Kroken 210,"Bohuslän,",139,39,178,6,1 447,5500000
Såld 28 november 2020,Mellan-Restad 355,"Bohuslän,",70,15,85,4,851,4160000
Såld 24 november 2020,Lönnvägen 1,"Ytterby,",137,6,143,6,630,4800000
Såld 24 november 2020,Hammarberg 900,"Kode,",75,4,79,4,1 106,2575000
Såld 23 november 2020,Brunnefjällsvägen 27,"Vedhall,",60,4,64,4,1 571,2300000
Såld 22 november 2020,Onyxvägen 5,"Kode,",155,5,160,5,532,5100000
Såld 20 november 2020,Olgas väg 1C,"Timmervik,",140,5,145,5,1 342,5525000
Såld 19 november 2020,Ametistvägen 1,"Kode,",98,92,190,5,936,4135000
Såld 18 november 2020,Ställets bygata 98,"Ytterby - Stället,",163,6,169,6,632,5850000
Såld 13 november 2020,Barlinds väg 23,"Marstrand - Instön,",114,5,119,5,1 340,7000000
Såld 11 november 2020,Slottsgatan 11,"Marstrand - Koön,",142,5,147,5,448,14000000
Såld 10 november 2020,Duvesjön 359,"Diseröd,",117,40,157,4,1 091,4170000
Såld 9 november 2020,Dalvägen 17,"Ödsmålsmosse,",45,40,85,4,1 036,2800000
Såld 4 november 2020,Bergkristallvägen 25,"Kode,",127,5,132,5,531,4700000
Såld 4 november 2020,Guddeby 172,"Ytterby,",143,6,149,6,1 090,5275000
Såld 29 oktober 2020,Kornhall 210,"Kornhall,",110,22,132,5,570,4060000
Såld 26 oktober 2020,Olserödsgatan 32,"Olseröd,",118,6,124,6,274,3905000
Såld 26 oktober 2020,Nolhagsvägen 22,"Aröd,",102,71,173,5,3 489,5000000
Såld 23 oktober 2020,Solberga 510,"Solberga,",98,58,156,4,1 517,4195000
Såld 23 oktober 2020,Grindbacken 17,"Grinden,",191,20,211,6,958,8600000
Såld 22 oktober 2020,Skårby station 453,"Kareby,",129,5,134,5,950,3995000
Såld 19 oktober 2020,Nämndemansvägen 25,"Ytterby,",136,25,161,4,560,4850000
Såld 16 oktober 2020,Harkeröd 380,"Hålta,",121,4,125,4,1 375,2995000
Såld 15 oktober 2020,Briljantvägen 23,"Kode,",149,6,155,6,445,4150000
Såld 13 oktober 2020,Överås 110,"Ytterby,",168,57,225,6,26 600,6545000
Såld 13 oktober 2020,Glose 660,"Kärna,",81,3,84,3,1 703,2900000
Såld 10 oktober 2020,Klockarvägen 4,"Diseröd,",154,6,160,6,561,3800000
Såld 9 oktober 2020,Hagtornsvägen 7,"Diseröd,",112,112,224,6,825,4500000
Såld 8 oktober 2020,Stenåldersgatan 52,"Stället,",117,4,121,4,345,4800000
Såld 7 oktober 2020,Diamantvägen 36,"Kungälv - Kode,",123,5,128,5,510,3775000
Såld 7 oktober 2020,Hammar 350,"Kornhall,",148,6,154,6,1 143,4500000
Såld 1 oktober 2020,Munkegärdegatan 21,"Munkegärde,",118,4,122,4,179,4300000
Såld 30 september 2020,Häljeröd 130,"Bohuslän,",128,4,132,4,1 267,3930000
Såld 29 september 2020,Solbräcke 212,"Solbräcke,",144,6,150,6,976,4995000
Såld 28 september 2020,Korpvägen 265,"Ullstorp,",133,18,151,6,401,5950000
Såld 28 september 2020,Vallhjonsgatan 8,"Marstrand - Koön,",162,6,168,6,748,8500000
Såld 26 september 2020,Hallbjörtorp 370,"Kärna,",30,30,60,2,1 535,2900000
Såld 26 september 2020,Rådmansgatan 4,"Kungälv - Centrum,",221,10,231,6,678,6400000
Såld 25 september 2020,Knaverstad-Ryr 590,"Aröd,",80,3,83,3,1 007,3100000
Såld 24 september 2020,Häljeröd 390,"Diseröd,",115,37,152,5,3 700,4500000
Såld 24 september 2020,Grenvägen 9,"Tjuvkil,",56,2,58,3,1 215,2530000
Såld 24 september 2020,Solskiftegatan 29,"Ytterby,",192,56,248,7,932,5700000
Såld 23 september 2020,Hermelingatan 11,"Kungälv - Olseröd,",126,25,151,5,548,5600000
Såld 22 september 2020,Ställets bygata 160,"Ytterby - Stället,",165,7,172,7,823,5900000
Såld 21 september 2020,Västerhöjdsvägen 30,"Kärna,",104,5,109,5,250,3760000
Såld 21 september 2020,Havregången 11,"Centrum,",150,42,192,4,588,4400000
Såld 20 september 2020,Nereby 340,"Harestad,",129,5,134,5,1 344,2700000
Såld 18 september 2020,Länsmansvägen 5,"Ytterby,",108,136,244,5,573,4600000
Såld 17 september 2020,Duvesjön 302,"Duvesjön,",120,74,194,4,1 506,5615000
Såld 16 september 2020,Skårby station 455,"Bohuslän,",,,0,,800,3995000
Såld 16 september 2020,Klövergången 6,"Centralt,",120,5,125,5,402,3440000
Såld 15 september 2020,Västerhöjdsvägen 40,"Kärna,",107,8,115,4,274,4100000
Såld 13 september 2020,Dösebacka 450,"Diseröd,",104,40,144,5,4 320,3520000
Såld 11 september 2020,Duvesjön 362,"Diseröd,",120,4,124,4,1 024,4220000
Såld 11 september 2020,Fjärdingsgatan 9,"Ytterby,",120,68,188,5,1 680,4650000
Såld 10 september 2020,Havregången 9,"Kungälv,",181,7,188,7,402,4415000
Såld 10 september 2020,Stinneröd 160,"Romelanda,",96,5,101,5,1 815,3525000
Såld 9 september 2020,Löstorp 180,"Kareby,",48,20,68,,84 425,5500000
Såld 9 september 2020,Trankärr 210,"Centralt,",209,47,256,8,2 855,6700000
Såld 9 september 2020,Trankärr 230,"Centralt,",152,34,186,6,2 056,4795000
Såld 8 september 2020,Stora Ryr 110,"Lycke,",116,76,192,7,1 434,3795000
Såld 8 september 2020,Kungälvsvägen 64,"Centralt,",137,58,195,5,853,5350000
Såld 5 september 2020,Bremnäs 190,"Lycke,",120,91,211,,1 559,2700000
Såld 5 september 2020,Prejelvägen 117,"Ullstorp,",122,15,137,5,596,5560000
Såld 4 september 2020,Lievägen 234,"Kungälv,",106,4,110,4,319,4850000
Såld 3 september 2020,Situlagatan 4,"Stället,",138,5,143,5,636,6040000
Såld 3 september 2020,Djupuddsvägen 2,"Marstrand - Instön,",135,5,140,5,1 268,5100000
Såld 3 september 2020,Hallbjörtorp 410,"Kärna,",172,6,178,6,1 884,5050000
Såld 1 september 2020,Tvetgatan 223,"Tveten,",130,5,135,5,138,3375000
Såld 30 augusti 2020,Grönviksvägen 22,"Kärna / Sundhammar,",130,70,200,4,1 741,6800000
Såld 28 augusti 2020,Kungälvsvägen 37,"Grinden,",89,4,93,4,227,3981000
Såld 27 augusti 2020,Marielundsvägen 11,"Koön,",166,6,172,6,1 074,6145000
Såld 27 augusti 2020,Harkvägen 347,"Ullstorp,",126,4,130,4,1 074,4500000
Såld 23 augusti 2020,Romelandavägen 110,"Centralt,",125,37,162,4,701,3700000
Såld 21 augusti 2020,Kareby kyrkväg 258,"Kareby,",106,4,110,4,617,3300000
Såld 21 augusti 2020,Gråstensvägen 14,"Kode,",94,96,190,5,1 424,3550000
Såld 21 augusti 2020,Klövergången 7,"Centralt,",125,4,129,4,401,4300000
Såld 20 augusti 2020,Stora Risby 540,"Bohuslän,",47,3,50,3,902,2725000
Såld 20 augusti 2020,Rävo 120,"Hålta,",96,64,160,5,1 819,2300000
Såld 17 augusti 2020,Rådmansgatan 21,"Kungälv - Centrum,",120,74,194,5,964,6530000
Såld 13 augusti 2020,Ametistvägen 12,"Kode,",107,5,112,5,918,4250000
Såld 13 augusti 2020,Lingonvägen 11,"Centralt,",123,24,147,4,742,5700000
Såld 12 augusti 2020,Munkegärdegatan 313,"Munkegärde,",135,20,155,5,309,4800000
Såld 12 augusti 2020,Norrmannebo 440,"Romelanda,",81,79,160,5,2 036,3550000
Såld 12 augusti 2020,Rostock 170,"Romelanda,",84,88,172,4,1 544,3500000
Såld 10 augusti 2020,Hallbjörtorp 350,"Kärna,",130,40,170,7,80 081,5100000
Såld 10 augusti 2020,Harkvägen 337,"Ullstorp,",131,5,136,5,80 081,5410000
Såld 5 augusti 2020,Mjölnarvägen 3,"Diseröd,",137,5,142,5,534,3830000
Såld 4 augusti 2020,Bredsten 300,"Bredsten,",119,0,119,,1 889,4100000
Såld 4 augusti 2020,Stinneröd 130,"Romelanda,",187,6,193,6,1 468,4150000
Såld 3 augusti 2020,Spaghamnsvägen 10,"Tjuvkil nära Marstrand,",165,20,185,5,1 280,12500000
Såld 31 juli 2020,Storskiftegatan 13,"Tega,",130,5,135,5,145,3800000
Såld 30 juli 2020,Hålta Annex 110,"Hålta,",217,8,225,8,42 350,7250000
Såld 28 juli 2020,Lid 170,"Diseröd,",86,51,137,4,6 235,2460000
Såld 27 juli 2020,Knaverstad-Ryr 450,"Kode,",78,3,81,3,885,3500000
Såld 25 juli 2020,Bergsgatan 10,"Marstrand Koön,",175,100,275,6,896,6900000
Såld 24 juli 2020,Bråta 140,"Romelanda,",35,5,40,3,2 165,1475000
Såld 23 juli 2020,Grokareby 210,"Kareby,",70,4,74,4,4 713,1250000
Såld 22 juli 2020,Hallebäcksvägen 13,"Timmervik,",113,50,163,5,3 636,4875000
Såld 21 juli 2020,Gamla Kungälvsvägen 9B,"Kungälv - Centralt,",194,6,200,6,1 061,7300000
Såld 21 juli 2020,Diamantvägen 52,"Kode,",156,5,161,5,557,4750000
Såld 21 juli 2020,Ametistvägen 4,"Kode,",98,95,193,5,866,4400000
Såld 14 juli 2020,Bollestad 310,"Bollestad,",140,6,146,6,6 876,4150000
Såld 10 juli 2020,Holm 310,"Kungälv - Kärna,",66,36,102,3,2 077,2970000
Såld 10 juli 2020,Skårshöjd 9,"Kärna,",112,4,116,4,988,4500000
Såld 9 juli 2020,Bärtas väg 8,"Kode,",57,3,60,3,1 503,3100000
Såld 9 juli 2020,Myrebackavägen 305,"Kareby,",166,6,172,6,1 504,4630000
Såld 3 juli 2020,Gråstensvägen 16,"Kode,",97,4,101,4,1 381,3650000
Såld 2 juli 2020,Knaverstad-Ryr 580,"Aröd,",158,4,162,6,1 012,3650000
Såld 1 juli 2020,Pölen 120,"Kungälv - Hålta,",138,75,213,5,812,4800000
Såld 30 juni 2020,Lerskärsvägen 18,"Kungälv - Tjuvkil,",65,65,130,5,1 216,3400000
Såld 30 juni 2020,Bremnäs 510,"Lycke,",85,45,130,4,2 915,2350000
Såld 29 juni 2020,Nedre Rådalsvägen 18,"Aröd/timmervik,",90,5,95,5,3 074,3100000
Såld 29 juni 2020,Hövdingagatan 3,"Komarken,",162,49,211,5,626,5300000
Såld 28 juni 2020,Enekullsvägen 24,"Ytterby,",200,24,224,7,980,5500000
Såld 26 juni 2020,Bärnstensvägen 9,"Kode,",100,95,195,5,1 547,4000000
Såld 25 juni 2020,Skårsäng 115,"Kärna,",114,13,127,5,616,4400000
Såld 25 juni 2020,Över-Restad 164,"Hålta,",6,0,6,6,1 077,4670000
Såld 24 juni 2020,Staby 260,"Staby,",115,90,205,6,1 125,2650000
Såld 23 juni 2020,Lundby 380,"Kareby,",140,5,145,5,1 818,4200000
Såld 23 juni 2020,Plogvägen 170,"Ullstorp,",122,5,127,5,266,5125000
Såld 18 juni 2020,Settungsvägen 28,"Kungälv,",141,24,165,6,429,6150000
Såld 18 juni 2020,Toftåsen 6,"Bohuslän,",74,3,77,3,1 066,3050000
Såld 18 juni 2020,Rörtången 111C,"Rörtången,",155,100,255,4,951,9600000
Såld 17 juni 2020,Mellan-Restad 340,"Bohuslän,",130,4,134,4,1 355,3900000
Såld 17 juni 2020,Skäggstorp 160,"Kode,",28,2,30,2,1 257,1350000
Såld 16 juni 2020,Ulvesund 110,"Ytterby,",153,50,203,5,2 830,4200000
Såld 15 juni 2020,Fridhemsgatan 3,"Centrum,",108,74,182,5,851,5200000
Såld 15 juni 2020,Ödsmål 360,"Rörtången,",105,66,171,5,794,3840000
Såld 10 juni 2020,Västra Röd 390,"Kärna,",123,25,148,5,843,3295000
Såld 10 juni 2020,Gårdskiftegatan 39,"Övre Tega,",171,21,192,6,830,5450000
Såld 10 juni 2020,Rådalsvägen 16,"Aröd,",61,2,63,2,2 090,2100000
Såld 9 juni 2020,Staby 490,"Kärna,",100,70,170,4,2 230,5000000
Såld 9 juni 2020,Matskärsvägen 36,"Tjuvkil,",56,3,59,3,1 077,2595000
Såld 9 juni 2020,Instö backe 110,"Instön,",49,2,51,2,3 027,2400000
Såld 9 juni 2020,Smidesvägen 6,"Kode,",95,60,155,6,846,3860000
Såld 8 juni 2020,Prejelvägen 126,"Ullstorp,",122,5,127,5,301,5050000
Såld 7 juni 2020,Bräcke 320,"Kärna,",148,56,204,6,7 880,5850000
Såld 5 juni 2020,Sundviksvägen 46,"Kungälv - Tjuvkil,",117,5,122,5,325,5650000
Såld 5 juni 2020,Staby 350,"Kungälv - Kärna,",145,75,220,5,911,3300000
Såld 4 juni 2020,Berghällsvägen 10,"Kode,",52,16,68,3,1 224,2495000
Såld 4 juni 2020,Tunge 310,"Bohuslän,",68,3,71,3,1 417,2055000
Såld 4 juni 2020,Bräcke 108,"Kärna,",190,5,195,5,6 662,5700000
Såld 4 juni 2020,Lingonvägen 23,"Centralt,",175,24,199,6,731,6150000
Såld 4 juni 2020,Skrindvägen 20,"Ullstorp,",141,5,146,5,488,5450000
Såld 3 juni 2020,Hammar 570,"Bohuslän,",129,4,133,4,3 315,3800000
Såld 3 juni 2020,Duvesjön 333,"Duvesjön,",125,31,156,4,1 073,3650000
Såld 2 juni 2020,Dannemarksgatan 16,"Övre Tega,",148,180,328,6,1 123,5150000
Såld 28 maj 2020,Byvägen 29,"Rörtången/ödsmålsmosse,",105,3,108,3,766,3200000
Såld 28 maj 2020,Korseberget 180,"Harestad,",151,5,156,5,1 216,4500000
Såld 26 maj 2020,Lundby 300,"KAREBY,",43,2,45,2,1 828,2250000
Såld 26 maj 2020,Åseby 150,"Solberga-Kode,",126,3,129,3,3 712,4500000
Såld 25 maj 2020,Staby 650,"Kärna,",94,88,182,5,1 011,3270000
Såld 23 maj 2020,Östra Röd 310,"Harestad,",154,6,160,6,999,4995000
Såld 22 maj 2020,Harkvägen 327,"Ullstorp,",131,5,136,5,999,4010000
Såld 21 maj 2020,Östra gatan 6,"Kungälv,",135,68,203,7,1 176,6750000
Såld 20 maj 2020,Dalvägen 6,"Kode,",52,30,82,2,1 378,2600000
Såld 20 maj 2020,Årsnäs 300,"Kode,",137,5,142,5,1 516,5900000
Såld 20 maj 2020,Älggatan 17,"Klöverbacken - Olseröd,",85,17,102,3,1 516,3200000
Såld 20 maj 2020,Skårsäng 105,"Kärna,",114,5,119,5,456,4300000
Såld 20 maj 2020,Krokens väg 22,"Tjuvkil (västra delen)+Kroken,",122,72,194,6,1 320,5900000
Såld 19 maj 2020,Bäckliden 10,"Kungälv,",169,79,248,7,500,7700000
Såld 18 maj 2020,Tronnum 260,"Kärna,",106,3,109,3,1 229,3500000
Såld 16 maj 2020,Rishammarvägen 12,"Kungälv,",185,26,211,7,747,6000000
Såld 14 maj 2020,Åkerhög 410,"Vedhall,",147,4,151,4,842,5000000
Såld 13 maj 2020,Grandalen 110,"Duvesjön,",66,2,68,2,1 121,2300000
Såld 13 maj 2020,Kållen 140,"Romelanda,",96,25,121,4,2 207,3200000
Såld 12 maj 2020,Kärnavägen 1,"Kärna,",159,90,249,8,668,4300000
Såld 12 maj 2020,Hamngatan 3,"Kungälv centralt,",144,76,220,6,620,6100000
Såld 12 maj 2020,Kvarnvägen 41,"Bohuslän,",111,45,156,5,1 194,3650000
Såld 11 maj 2020,Krokens väg 21,"Lycke,",157,6,163,6,968,5950000
Såld 10 maj 2020,Åseby 120,"Kode / Solberga,",91,71,162,3,19 952,3825000
Såld 6 maj 2020,Byvägen 63,"Ödsmålsmosse,",104,5,109,5,1 750,3750000
Såld 6 maj 2020,Toftåsen 3,"Sundhammar,",137,36,173,6,1 235,5975000
Såld 6 maj 2020,Gullbringa 110,"Lökeberg,",180,6,186,6,2 068,4300000
Såld 6 maj 2020,Skäggstorp 180,"Kode,",52,2,54,2,1 353,2450000
Såld 5 maj 2020,Källeröd 166,"Kareby,",126,6,132,6,988,4295000
Såld 5 maj 2020,Skårshöjd 8,"Kärna,",140,40,180,6,921,3700000
Såld 4 maj 2020,Lievägen 245,"Ullstorp,",111,4,115,4,487,5150000
Såld 1 maj 2020,Flädervägen 17,"Diseröd,",110,4,114,4,332,3600000
Såld 30 april 2020,Duvesjön 230,"Duvesjön,",119,4,123,4,1 091,4450000
Såld 29 april 2020,Olserödsgatan 128,"Kungälv,",150,39,189,4,1 388,4650000
Såld 29 april 2020,Instölid 33,"Instön,",55,3,58,3,841,3950000
Såld 28 april 2020,Tjällviksvägen 4,"Marstrand,",74,2,76,2,822,2650000
Såld 28 april 2020,Grokareby 130,"Kareby,",200,26,226,6,6 284,3825000
Såld 28 april 2020,Häljeröd 280,"Romelanda,",199,24,223,7,3 235,3700000
Såld 28 april 2020,Älggatan 6,"Olseröd,",111,4,115,4,3 235,3375000
Såld 27 april 2020,Hemmansgatan 2,"Ytterby,",179,8,187,8,1 021,4800000
Såld 25 april 2020,Västra Röd 130,"Harestad,",136,15,151,5,1 170,4200000
Såld 24 april 2020,Bergåsvägen 17,"Ytterby,",126,49,175,6,1 054,4600000
Såld 24 april 2020,Åseby 170,"Åseby,",101,3,104,3,1 945,3500000
Såld 23 april 2020,Aspvägen 7A,"Kungälv - Ytterby,",106,104,210,6,640,4725000
Såld 22 april 2020,Hammar 150,"Harestad,",95,65,160,4,1 391,1895000
Såld 22 april 2020,Ingegatan 2E,"Komarken,",102,49,151,5,108,3600000
Såld 21 april 2020,Tvetgatan 289,"Tveten,",130,9,139,5,127,3700000
Såld 19 april 2020,Prästvägen 238,"Kareby,",177,7,184,7,1 401,5400000
Såld 18 april 2020,Hammarberg 880,"Kode,",71,3,74,3,2 037,2450000
Såld 17 april 2020,Källeröd 168,"Kareby,",126,6,132,6,1 000,4395000
Såld 17 april 2020,Tjällviksvägen 14,"Instön,",138,4,142,4,3 032,4150000
Såld 16 april 2020,Ingetorp 190,"Kode,",70,12,82,4,2 160,2860000
Såld 7 april 2020,Bokvägen 8,"Centralt,",170,40,210,8,635,6650000
Såld 3 april 2020,Önneröd 145,"Bohuslän,",110,4,114,4,1 030,4800000
Såld 3 april 2020,Skårby 774,"Bohuslän,",151,7,158,7,2 155,5300000
Såld 2 april 2020,Lerskärsvägen 11,"Lycke,",63,19,82,,1 065,2750000
Såld 2 april 2020,Löstorp 120,"Kareby,",93,100,193,6,1 313,3620000
Såld 2 april 2020,Flädervägen 48,"Diseröd,",182,10,192,7,823,5455000
Såld 2 april 2020,Lievägen 232,"Ullstorp,",134,5,139,5,257,5420000
Såld 1 april 2020,Lilla Fjellsholmen 33,"Lilla Fjellsholmen,",108,18,126,4,412,7900000
Såld 1 april 2020,Vitsten 210,"Kode,",50,3,53,3,1 191,1200000
Såld 1 april 2020,Orrstigen 8,"Bohuslän,",128,0,128,,361,4220000
Såld 31 mars 2020,Duvesjön 216,"Bohuslän,",153,5,158,5,2 091,4135000
Såld 30 mars 2020,Lyckan 2,"Komarken,",111,60,171,7,861,3630000
Såld 28 mars 2020,Klövergången 8,"Centralt,",125,4,129,4,402,3730000
Såld 27 mars 2020,Häradsvägen 30,"Ytterby,",130,0,130,,372,2400000
Såld 27 mars 2020,Murhammarvägen 1,"Kareby,",122,5,127,5,822,3510000
Såld 27 mars 2020,Löstorp 160,"Kareby,",62,24,86,3,1 282,2850000
Såld 27 mars 2020,Ädelstensvägen 52,"Kode,",123,3,126,3,334,4150000
Såld 27 mars 2020,Sundhammarsvägen 480,"Sundhammar,",167,6,173,6,2 290,4680000
Såld 26 mars 2020,Harkvägen 343,"Kungälv,",131,5,136,5,2 290,4000000
Såld 26 mars 2020,Östergårdsgatan 61,"Tega,",179,6,185,6,1 204,5010000
Såld 23 mars 2020,Rishammarvägen 11,"Kareby,",115,28,143,6,2 862,5525000
Såld 20 mars 2020,Beryllvägen 25,"Kode,",123,5,128,5,383,4100000
Såld 12 mars 2020,Västra gatan 18B,"Centrum,",160,6,166,6,746,6000000
Såld 11 mars 2020,Alvägen 1,"Diseröd,",126,43,169,6,668,3795000
Såld 9 mars 2020,Byvägen 50,"Ödsmålsmosse,",163,52,215,5,1 275,4400000
Såld 7 mars 2020,Kulleskärsvägen 37,"Tjuvkil/Lycke,",64,3,67,3,1 456,2650000
Såld 6 mars 2020,Skårsäng 25,"Kärna,",147,9,156,6,547,4650000
Såld 5 mars 2020,Häljeröd 380,"Diseröd,",140,190,330,7,3 521,4425000
Såld 3 mars 2020,Östergårdsgatan 27,"Ytterby,",156,5,161,5,777,4450000
Såld 3 mars 2020,Tjuvkil 140,"Tjuvkil,",80,12,92,3,2 819,2900000
Såld 2 mars 2020,Fontinvägen 32,"Kungälv Centralt,",160,50,210,7,811,6300000
Såld 2 mars 2020,Duvesjön 327,"Kungälv -Duvesjön,",103,24,127,4,1 320,3900000
Såld 1 mars 2020,Ulvedalsgatan 10,"Ulvegärde,",154,5,159,5,1 031,5100000
Såld 28 februari 2020,Truskärsvägen 9C,"Tjuvkil,",168,7,175,7,1 039,5750000
Såld 27 februari 2020,Ivar Claessons gata 8,"Kungälv,",121,30,151,6,1 103,5500000
Såld 26 februari 2020,Storskiftegatan 71,"Övre Tega,",129,28,157,5,798,5600000
Såld 26 februari 2020,Krappvägen 556,"Bohuslän,",174,40,214,6,783,7925000
Såld 23 februari 2020,Fregattgatan 6,"Centralt vid älven,",180,7,187,7,630,5330000
Såld 21 februari 2020,Nolby 325,"Kungälv,",159,4,163,4,29 096,6700000
Såld 21 februari 2020,Stenåldersgatan 59,"Ytterby,",107,5,112,5,400,4520000
Såld 21 februari 2020,Brunnefjällsvägen 26,"Kärna,",79,5,84,3,1 157,2360000
Såld 19 februari 2020,Reidarsgatan 3,"Centralt vid älven,",150,28,178,5,686,5350000
Såld 19 februari 2020,Lefstadvägen 27,"Kärna,",113,21,134,3,1 351,4090000
Såld 11 februari 2020,Fågelstigen 41,"Centralt,",126,5,131,5,590,4300000
Såld 10 februari 2020,Täljstensgatan 2,"Stället,",70,3,73,3,551,3600000
Såld 7 februari 2020,Rishammar 110,"Kareby,",140,19,159,6,1 205,4135000
Såld 6 februari 2020,Solbräcke 214,"Kungälv,",148,4,152,4,882,4950000
Såld 5 februari 2020,Lilla Fjellsholmen 17,"Lilla Fjellsholmen,",5,0,5,5,400,6900000
Såld 3 februari 2020,Mariebergsvägen 150,"Kungälv,",173,86,259,8,4 083,4250000
Såld 2 februari 2020,Åsebyberg 940,"Kode,",138,30,168,5,57 649,4400000
Såld 30 januari 2020,Jägarvägen 5,"Diseröd,",168,8,176,7,550,3795000
Såld 28 januari 2020,Staby 780,"Kärna,",108,50,158,4,2 026,3050000
Såld 28 januari 2020,Gräsgången 1,"Komarken,",125,4,129,4,435,4100000
Såld 28 januari 2020,Toreby mosse 600,"Harestad och Kärna,",104,16,120,4,1 622,3900000
Såld 28 januari 2020,Hemvägen 19,"Romelanda,",119,19,138,5,381,2900000
Såld 24 januari 2020,Lerskärsvägen 51,"Lycke,",75,4,79,4,1 591,3125000
Såld 22 januari 2020,Gårdskiftegatan 72,"Ytterby,",105,109,214,6,856,5050000
Såld 22 januari 2020,Onyxvägen 14,"Kode,",123,5,128,5,546,4125000
Såld 21 januari 2020,Duvesjön 201,"Bohuslän,",38,9,47,2,1 390,1880000
Såld 21 januari 2020,Kyrkeby 296,"Kärna,",146,5,151,5,1 499,4300000
Såld 19 januari 2020,Sundviksvägen 36,"Tjuvkil/lycke,",117,5,122,5,533,5495000
Såld 18 januari 2020,Kungälvsvägen 51,"Grinden,",89,4,93,4,215,4100000
Såld 17 januari 2020,Norrmannebo 540,"Norrmannebo,",115,55,170,5,4 495,3420000
Såld 17 januari 2020,Hallebäcksvägen 18,"Timmervik,",62,3,65,3,1 336,2215000
Såld 17 januari 2020,Gråstensvägen 11,"Kode,",125,80,205,8,1 628,3150000
Såld 15 januari 2020,Guntorpsvägen 24,"Kode,",110,152,262,6,1 065,5000000
Såld 10 januari 2020,Västerängen 5,"Ytterby,",106,44,150,6,1 046,5175000
Såld 10 januari 2020,Munkegärdegatan 339,"Kungälv,",117,5,122,5,659,5100000
Såld 9 januari 2020,Holm 230,"Kovikshamn,",155,7,162,7,2 861,5875000
Såld 3 januari 2020,Opalvägen 10,"Kode,",130,50,180,5,712,2900000
Såld 27 december 2019,Ön 170,"Kareby,",120,84,204,5,3 272,3500000
Såld 27 december 2019,Bräcke 106,"Kärna,",127,4,131,4,2 070,4600000
Såld 22 december 2019,Solrosvägen 7,"Kärna,",138,90,228,5,592,4375000
Såld 20 december 2019,Broberg 190,"Tjuvkil/Lycke,",67,4,71,4,1 755,1850000
Såld 20 december 2019,Prejelvägen 120,"Kungälv,",122,0,122,,314,5100000
Såld 20 december 2019,Matskärsvägen 2,"Kungälv - Tjuvkil,",130,4,134,4,594,4650000
Såld 20 december 2019,Dannemarksgatan 42,"Ytterby,",148,6,154,6,641,5400000
Såld 15 december 2019,Spaghamnsvägen 15,"Tjuvkil/Lycke,",114,3,117,3,1 407,6500000
Såld 12 december 2019,Lilla Fjellsholmen 6,"Lilla Fjellsholmen,",86,4,90,4,400,6900000
Såld 11 december 2019,Ulvesund 438,"Ytterby,",90,5,95,5,760,4500000
Såld 9 december 2019,Hallbjörtorp 200,"Hallbjörtorp,",90,3,93,3,1 458,1000000
Såld 6 december 2019,Bergåsvägen 6B,"Ytterby,",141,29,170,5,1 021,5400000
Såld 3 december 2019,Settungsvägen 44,"Ullstorp,",120,25,145,5,583,5100000
Såld 30 november 2019,Skurhagagatan 4,"Kungälv - Centrum,",190,75,265,7,798,5300000
Såld 28 november 2019,Rörmossevägen 130,"Bohuslän,",145,113,258,5,1 200,4480000
Såld 28 november 2019,Törnrosgatan 10,"Ytterby,",136,76,212,7,1 030,5375000
Såld 27 november 2019,Vävra 542,"Hålta,",109,15,124,6,1 106,4550000
Såld 25 november 2019,Vallby 110,"Solberga-Kode,",127,14,141,5,12 135,5100000
Såld 22 november 2019,Olsåker 200,"Kareby,",106,156,262,6,1 673,3600000
Såld 22 november 2019,Enekullsvägen 6,"Ytterby,",170,94,264,8,1 160,6900000
Såld 21 november 2019,Åsebyberg 655,"Åsebyberg,",35,2,37,2,2 854,2080000
Såld 20 november 2019,Ljungvägen 40,"Ödsmålsmosse vid Rörtången,",65,3,68,3,1 016,2295000
Såld 20 november 2019,Bergkristallvägen 18,"Kode,",127,6,133,6,608,4450000
Såld 20 november 2019,Solberga 870,"Kode,",104,38,142,3,1 272,3420000
Såld 16 november 2019,Kuskalundsvägen 35,"Vävra,",63,3,66,3,2 104,2450000
Såld 16 november 2019,Trankärr 170,"Trankärr,",86,60,146,3,1 002,3880000
Såld 13 november 2019,Granndalen 13,"Kärna,",81,10,91,4,1 093,2100000
Såld 13 november 2019,Solbräcke / Ullstorp,"Kungälv,",148,6,154,6,784,4950000
Såld 13 november 2019,Grindklykan 9,"Kungälv,",121,4,125,4,729,3900000
Såld 6 november 2019,Täljstensgatan 4,"Ytterby,",70,12,82,3,478,3100000
Såld 6 november 2019,Duvesjön 357,"Romelanda,",169,60,229,9,1 054,4625000
Såld 1 november 2019,,"Kungälv,",,,0,,708,1251360
Såld 1 november 2019,Kulperödsvägen 39,"Gullbringa,",129,4,133,4,1 192,2900000
Såld 1 november 2019,Topasvägen 13,"Kode,",130,95,225,6,782,4500000
Såld 30 oktober 2019,Råckeröd 180,"Kärna,",90,0,90,,3 183,1000000
Såld 30 oktober 2019,Enebacksvägen 10,"Kode,",69,36,105,4,1 051,2720000
Såld 30 oktober 2019,Lerskärsvägen 11,"Tjuvkil,",63,75,138,3,1 065,2830000
Såld 29 oktober 2019,Jägersberg 350,"Kode,",94,32,126,4,4 120,3405000
Såld 29 oktober 2019,Lilla Fjellsholmen 16,"Lilla Fjellsholmen,",86,4,90,4,435,7500000
Såld 29 oktober 2019,Häradsvägen 92,"Ytterby centralt,",130,5,135,5,386,3595000
Såld 25 oktober 2019,Hasselvägen 5,"Romelanda,",115,166,281,,972,4060000
Såld 25 oktober 2019,Häradsvägen 82,"Ytterby,",130,7,137,7,361,4350000
Såld 25 oktober 2019,Fridhemsgatan 23,"Centralt,",134,40,174,6,738,5250000
Såld 24 oktober 2019,Slånbärsvägen 6,"Kungälv - Centralt,",156,7,163,7,1 010,5750000
Såld 23 oktober 2019,Hasselvägen 1,"Diseröd,",106,106,212,6,1 032,3825000
Såld 23 oktober 2019,Solhultsgatan 18,"Centralt,",152,72,224,6,555,4795000
Såld 21 oktober 2019,Glöskär 950,"Kungälv - Kärna,",190,50,240,7,17 790,6000000
Såld 19 oktober 2019,Östergårdsgatan 25,"Ytterby,",177,7,184,7,831,4695000
Såld 18 oktober 2019,Romelandavägen 112,"Centralt,",75,30,105,4,371,2695000
Såld 17 oktober 2019,Myrebackavägen 102,"Bohuslän,",129,5,134,5,2 531,4535000
Såld 16 oktober 2019,Duvesjön 180,"Romelanda,",47,2,49,2,1 650,2115000
Såld 11 oktober 2019,Kungälvsvägen 22,"Centralt,",77,46,123,5,1 548,3760000
Såld 11 oktober 2019,Håltet 140,"Kareby,",132,5,137,5,2 219,4010000
Såld 4 oktober 2019,Länsmansvägen 30,"Ytterby,",133,55,188,5,972,4650000
Såld 2 oktober 2019,Gamla Trollhättevägen 11,"Centralt,",60,36,96,3,654,3700000
Såld 1 oktober 2019,Veneröd 430,"Hålta,",92,4,96,4,1 376,3395000
Såld 28 september 2019,Bäckgatan 16,"Kungälv - Centrum,",135,65,200,4,732,5700000
Såld 27 september 2019,Topasvägen 11,"Bohuslän,",103,95,198,6,742,3750000
Såld 26 september 2019,Mantalsgatan 17,"Ytterby,",189,23,212,6,986,4800000
Såld 26 september 2019,Grindvakten 25,"Grinden,",127,3,130,3,473,3850000
Såld 25 september 2019,Solbräcke 1:47,"Kungälv,",,,0,,708,1000000
Såld 25 september 2019,Solbräcke 1:46,"Kungälv,",,,0,,784,1000000
Såld 25 september 2019,Solbräcke 1:45,"Kungälv,",,,0,,976,1000000
Såld 25 september 2019,Solbräcke 1:44,"Bohuslän,",,,0,,882,1000000
Såld 25 september 2019,Lundby 340,"Kungälv - Kareby,",147,6,153,6,1 648,4100000
Såld 23 september 2019,Teggatan 8,"Fridhemskullen,",177,21,198,5,759,5900000
Såld 19 september 2019,Skårsäng 39,"Kärna,",114,5,119,5,473,4400000
Såld 18 september 2019,Mellan-Restad 380,"Bohuslän,",140,15,155,6,3 583,5025000
Såld 16 september 2019,Dösebacka 620,"Romelanda,",91,76,167,5,1 498,3295000
Såld 15 september 2019,Solhultsgatan 21,"Komarken,",173,127,300,7,560,4900000
Såld 13 september 2019,Mycklaborgsgatan 10,"Komarken,",190,76,266,9,1 110,5756725
Såld 12 september 2019,Gamla Trollhättevägen 16,"Kungälv,",80,30,110,4,524,3300000
Såld 11 september 2019,Jägersberg 242,"Kode,",121,5,126,5,1 864,4200000
Såld 6 september 2019,Åkerhög 180,"Vedhall,",142,5,147,5,1 057,3650000
Såld 5 september 2019,Duvesjön 213,"Kungälv -Duvesjön,",120,4,124,4,909,4000000
Såld 5 september 2019,Lundby 250,"Kungälv - Kareby,",151,6,157,6,1 873,4575000
Såld 3 september 2019,Briljantvägen 22,"Bohuslän,",150,6,156,6,575,4210000
Såld 3 september 2019,Täljstensgatan 5,"Ytterby,",104,19,123,4,356,4510000
Såld 1 september 2019,Hövdingagatan 7,"Komarken,",132,48,180,7,655,4275000
Såld 31 augusti 2019,Lundby 460,"Kareby,",140,38,178,5,1 825,3790000
Såld 31 augusti 2019,Marias väg 32,"Aröd,",85,4,89,4,1 058,3325000
Såld 29 augusti 2019,Skäggstorp 120,"Kode,",51,43,94,4,1 756,2240000
Såld 28 augusti 2019,Bergkristallvägen 23,"Kode,",130,5,135,5,504,4500000
Såld 28 augusti 2019,Stora Risby 530,"Hålta,",62,53,115,4,925,3000000
Såld 25 augusti 2019,Nordängen 10,"Sundhammar,",174,18,192,5,1 331,5000000
Såld 24 augusti 2019,Lefstadvägen 31,"Kärna,",130,5,135,5,881,4150000
Såld 24 augusti 2019,Diamantvägen 54,"Kode,",155,6,161,6,560,3820000
Såld 23 augusti 2019,Råckeröd 170,"Kärna,",210,85,295,7,2 388,4550000
Såld 23 augusti 2019,Gustavsbergsvägen 17,"Tega,",111,4,115,4,1 360,4330000
Såld 22 augusti 2019,Hammarhöjden 650,"Kode,",68,4,72,4,1 157,2650000
Såld 21 augusti 2019,Olserödsgatan 16,"Olseröd,",118,5,123,5,238,3875000
Såld 20 augusti 2019,Lysegården 110,"Romelanda,",156,36,192,5,2 899,3380000
Såld 19 augusti 2019,Vävra 433,"Hålta,",198,6,204,6,1 729,5300000
Såld 16 augusti 2019,Munkholmsgatan 2,"Komarken,",137,73,210,7,893,5400000
Såld 16 augusti 2019,Staby 360,"Kungälv - Kärna,",119,75,194,5,1 020,2900000
Såld 16 augusti 2019,Beryllvägen 2,"Kode,",128,5,133,6,908,4455000
Såld 16 augusti 2019,Grindvakten 27,"Kungälv Grinden,",121,4,125,4,312,3750000
Såld 15 augusti 2019,Holm 440,"Kärna,",131,13,144,5,1 408,4275000
Såld 14 augusti 2019,Tolleröd 280,"Kungälv,",73,3,76,3,1 446,3330000
Såld 13 augusti 2019,Hasselvägen 5,"Romelanda,",115,166,281,,972,1900000
Såld 13 augusti 2019,Vetegången 15,"Centralt,",124,4,128,4,403,4100000
Såld 12 augusti 2019,Staby 750,"Kärna,",117,151,268,7,2 787,4325000
Såld 2 augusti 2019,Solvagnsgatan 2,"Ytterby,",164,12,176,5,484,5455000
Såld 1 augusti 2019,Aspvägen 8,"Ytterby,",130,90,220,5,602,4680000
Såld 1 augusti 2019,Rönnvägen 17,"Diseröd,",125,80,205,6,805,3500000
Såld 20 juli 2019,Prästvägen 990,"Diseröd,",191,107,298,5,1 941,5000000
Såld 18 juli 2019,Kulleskärsvägen,"Tjuvkil,",142,6,148,6,410,4893000
Såld 16 juli 2019,Lilla Fjellsholmen 61,"Vedhall,",86,4,90,4,405,6500000
Såld 12 juli 2019,Sjöhåla 120,"Kovikshamn,",65,2,67,2,1 662,1870000
Såld 11 juli 2019,Bergliden 5,"Kode,",68,16,84,3,1 945,2970000
Såld 9 juli 2019,Snäckliden 2,"Sundhammar,",120,30,150,5,1 085,4800000
Såld 5 juli 2019,Kantorvägen 5,"Bohuslän,",125,5,130,5,574,3495000
Såld 5 juli 2019,Vävra 470,"Hålta,",160,10,170,5,3 244,2900000
Såld 5 juli 2019,Valeberg 105,"Solberga-Kode,",98,55,153,4,2 957,3350000
Såld 3 juli 2019,Ranneberg 200,"Kärna,",66,63,129,4,3 315,2250000
Såld 3 juli 2019,Bergsvägen 15,"Ödsmålsmosse/Rörtången,",57,4,61,4,1 784,1600000
Såld 2 juli 2019,Vitsippegatan 12,"Ytterby,",179,21,200,6,535,4650000
Såld 1 juli 2019,Hanekullen 205,"Kareby,",196,6,202,6,1 885,4750000
Såld 28 juni 2019,Dotorp 250,"Kärna,",126,32,158,5,1 449,3825000
Såld 27 juni 2019,Över-Restad 210,"Hålta,",107,5,112,5,2 738,1700000
Såld 26 juni 2019,Hövdingagatan 1,"Komarken,",163,160,323,6,1 030,5200000
Såld 25 juni 2019,Ängsgatan 17,"Centralt,",102,102,204,5,574,4620000
Såld 23 juni 2019,Ranneberg 180,"Kärna,",95,55,150,5,1 204,2810000
Såld 20 juni 2019,Bastubäcksvägen 38,"Ödsmålsmosse/Rörtången,",63,3,66,3,767,2900000
Såld 20 juni 2019,Enskiftegatan 14,"Ytterby,",170,73,243,7,924,5575000
Såld 20 juni 2019,Häljeröd 420,"Romelanda,",146,62,208,5,1 172,3800000
Såld 20 juni 2019,Strömgatan 3,"Ytterby,",94,47,141,5,955,4750000
Såld 19 juni 2019,Grindslanten 14,"Grinden,","112,7",15,,5,955,3000000
Såld 19 juni 2019,Skogen 148,"Kareby,",145,6,151,6,2 156,5100000
Såld 15 juni 2019,Norrmannebo 200,"Romelanda,",127,71,198,6,3 500,3200000
Såld 14 juni 2019,Vråstigen 2,"Bohuslän,",95,35,130,6,1 661,3300000
Såld 14 juni 2019,Skårby 590,"Kareby,",65,10,75,2,1 132,2350000
Såld 13 juni 2019,Blåsippegatan 14,"Ytterby,",201,6,207,6,833,4000000
Såld 12 juni 2019,Granndalen 19,"Lycke,",49,4,53,4,1 421,1700000
Såld 11 juni 2019,Länsmansvägen 28,"Ytterby,",127,51,178,6,862,4707000
Såld 10 juni 2019,Nordön 180,"Tjuvkil,",80,80,160,5,1 587,4850000
Såld 7 juni 2019,Barlinds väg  7,"Marstrand,",90,5,95,5,1 527,4490000
Såld 7 juni 2019,Skårby 985,"Bohuslän,","165,6",5,,5,1 655,4750000
Såld 5 juni 2019,Brunskär 510,"Kärna,",90,15,105,4,365,4250000
Såld 4 juni 2019,Kastellegårdsvägen 220,"Kastellegården,",4,0,4,4,1 450,4050000
Såld 3 juni 2019,Stora Ryr 240,"Lycke,",120,4,124,4,1 071,3200000
Såld 3 juni 2019,Svartbrödragatan 6,"Komarken,",124,70,194,5,1 086,5035000
Såld 3 juni 2019,Norgårdsvägen 7,"Tjuvkil,",102,57,159,4,808,3200000
Såld 2 juni 2019,Hammarberg 860,"Hammarberg,",43,3,46,3,1 017,760000
Såld 31 maj 2019,Korpedalsvägen 9,"Aröd,",48,4,52,4,1 317,3100000
Såld 30 maj 2019,Kareby kyrkväg 220,"Bohuslän,",131,95,226,6,1 498,4275000
Såld 30 maj 2019,Lilla Fjellsholmen 58,"Lilla Fjellsholmen,",4,0,4,4,431,6100000
Såld 29 maj 2019,Krappvägen 581,"Bohuslän,",121,6,127,6,316,5100000
Såld 28 maj 2019,Matskärsvägen 14B,"Tjuvkil,",145,6,151,6,331,4500000
Såld 28 maj 2019,Knapegården 126,"Bohuslän,",143,40,183,6,3 842,4900000
Såld 27 maj 2019,Vallby 110,"Solberga-Kode,",127,14,141,5,12 135,5050000
Såld 24 maj 2019,Munkegärdegatan 309,"Munkegärde,",118,16,134,4,440,4135000
Såld 21 maj 2019,Berghällsvägen 18,"Timmervik,",73,4,77,4,1 221,2400000
Såld 17 maj 2019,Solskiftegatan 33,"Ytterby,",166,47,213,6,773,4600000
Såld 17 maj 2019,Solberga 660,"Solberga-Kode,",162,5,167,5,1 664,5320000
Såld 16 maj 2019,Aspvägen 3,"Ytterby,",144,92,236,7,1 561,5610000
Såld 16 maj 2019,Lagvägen 45,"Ytterby,",161,5,166,5,647,4700000
Såld 14 maj 2019,Kareby kyrkväg 260,"Kareby,",170,58,228,5,2 934,3300000
Såld 14 maj 2019,Halltorpsvägen 9,"Kode,",96,70,166,5,1 293,3800000
Såld 13 maj 2019,Akvamarinvägen 6,"Kode,",98,95,193,5,780,3000000
Såld 13 maj 2019,Norra Arödsvägen 12,"Bohuslän,",100,24,124,3,1 883,3100000
Såld 12 maj 2019,Storskiftegatan 67,"Ytterby,",117,49,166,5,921,5130000
Såld 10 maj 2019,Tegskiftegatan 70,"Ytterby,",117,117,234,7,1 020,5140000
Såld 10 maj 2019,Oskarsberg 130,"Kareby,",135,16,151,4,2 796,3300000
Såld 9 maj 2019,Jägersberg 340,"Bohuslän,",146,30,176,5,29 613,5750000
Såld 8 maj 2019,Kristinedalsgatan 5,"Bohuslän,",137,67,204,5,701,6700000
Såld 6 maj 2019,Kyrkeby 290,"Kärna - Harestad,",146,5,151,5,3 580,4510000
Såld 6 maj 2019,Vallvägen 12,"Kareby,",7,0,7,7,2 819,8345000
Såld 4 maj 2019,Ragnhildsgatan 2,"Centralt,",115,53,168,5,775,4100000
Såld 2 maj 2019,Rådalsvägen 25,"Aröd,",88,4,92,4,1 462,2600000
Såld 30 april 2019,Prästbol 120,"Kode,",98,5,103,5,1 380,3400000
Såld 30 april 2019,Hällristningsgatan 12,"Stället,",107,4,111,4,560,4450000
Såld 29 april 2019,Ängsgatan 28B,"Centrum,",84,4,88,4,136,2800000
Såld 27 april 2019,Ljungvägen  28,"Ödsmålsmosse vid Rörtången,",85,4,89,4,388,3300000
Såld 26 april 2019,Kristinedalsgatan 3,"Centrum,",87,82,169,5,1 231,5500000
Såld 24 april 2019,Broberg 120,"Tjuvkil,",85,18,103,3,2 064,3075000
Såld 19 april 2019,Hallbjörtorp 490,"Kärna,",150,5,155,5,1 497,4100000
Såld 19 april 2019,Häljeröd 400,"Romelanda,",89,89,178,4,1 181,2935000
Såld 19 april 2019,Önneröd 174,"Kärna,",145,5,150,5,4 308,4675000
Såld 18 april 2019,Grindvakten 2,"Grinden,",121,4,125,4,396,3900000
Såld 18 april 2019,Vältvägen 515,"Ullstorp,",121,5,126,5,371,5125000
Såld 17 april 2019,Tolleröd 160,"Kode,",104,48,152,5,1 582,3400000
Såld 15 april 2019,Bokvägen 11,"Fontin,",112,17,129,5,600,5325000
Såld 15 april 2019,Hällristningsgatan 22,"Ytterby,",103,4,107,4,264,3950000
Såld 14 april 2019,Kuskalundsvägen 5,"Hålta,",75,20,95,3,1 776,2800000
Såld 14 april 2019,Prästbol 185,"Aröd,",129,4,133,4,2 008,5400000
Såld 12 april 2019,Munkholmsgatan 5,"Kungälv,",117,50,167,4,759,4550000
Såld 11 april 2019,Plommeröd 160,"Romelanda,",59,3,62,3,1 418,1580000
Såld 11 april 2019,Gunneröd 320,"Kärna Lycke,",145,5,150,5,1 144,3550000
Såld 2 april 2019,Skrivarevägen 48,"Ytterby,",104,4,108,4,167,2995000
Såld 1 april 2019,Brunnefjällsvägen  18,"Kärna,",83,3,86,3,1 196,3000000
Såld 1 april 2019,Dannemarksgatan 4,"Tega - Ytterby,",112,151,263,6,990,4710000
Såld 31 mars 2019,Alekärr 110,"Diseröd,",118,149,267,6,1 611,3500000
Såld 29 mars 2019,Duvesjön 460,"Duvesjön,",64,3,67,3,1 986,2260000
Såld 25 mars 2019,Solvagnsgatan 22,"Ytterby - Stället,",139,12,151,5,370,5000000
Såld 25 mars 2019,Lagvägen 27,"Ytterby,",110,38,148,6,692,3810000
Såld 21 mars 2019,Grannebydal 260,"Hålta,",120,4,124,4,1 574,2300000
Såld 17 mars 2019,Solvagnsgatan 32,"Ytterby,",138,5,143,5,385,5200000
Såld 15 mars 2019,Hammar 510,"Kode,",143,140,283,,3 324,3900000
Såld 13 mars 2019,Skolstigen 2,"Kungälv,",150,20,170,7,1 080,4570000
Såld 6 mars 2019,Munkegärdegatan 99,"Blodriskan,",134,25,159,5,345,4350000
Såld 4 mars 2019,Kyrkeby 220,"Harestad,",109,4,113,4,6 999,4750000
Såld 1 mars 2019,Kulperödsvägen 35,"Bohuslän,",143,5,148,5,3 089,4050000
Såld 28 februari 2019,Tjäderstigen  4,"Kungälv - Centralt,",126,4,130,4,362,4285000
Såld 28 februari 2019,Flateby 450,"Harestad,",163,118,281,8,1 351,3630000
Såld 27 februari 2019,Bergkristallvägen 18,"Kode,",127,6,133,6,608,4400000
Såld 27 februari 2019,Prästvägen 710,"Romelanda,",166,20,186,8,1 034,4300000
Såld 24 februari 2019,Granndalen 14,"Bohuslän,",70,54,124,4,1 229,2995000
Såld 22 februari 2019,Ranneberg  154,"Kärna,",165,4,169,4,2 381,5200000
Såld 21 februari 2019,Kvarnvägen 22,"Kode,",68,68,136,5,1 318,3570000
Såld 18 februari 2019,Lingonvägen 43,"Centralt,",126,5,131,5,383,4050000
Såld 15 februari 2019,Hamngatan 11,"Centralt,",84,94,178,3,636,4890000
Såld 14 februari 2019,Rönnvägen  22,"Romelanda,",108,70,178,5,823,3375000
Såld 14 februari 2019,Lyckevägen  9,"Kärna,",190,150,340,9,2 284,4300000
Såld 14 februari 2019,Ekvägen 12,"Ytterby,",125,83,208,6,770,4000000
Såld 13 februari 2019,Rostock 362,"Bohuslän,","131,5",5,,5,1 070,4650000
Såld 12 februari 2019,Tjuvkil 460,"Tjuvkil,",115,20,135,4,1 231,3900000
Såld 11 februari 2019,Sjöhed 310,"Kärna - Harestad,",103,81,184,5,1 208,3700000
Såld 11 februari 2019,Galärgatan 3,"Komarken,",108,65,173,4,628,4200000
Såld 8 februari 2019,Bastövägen 4,"Överön - Kärna,",100,60,160,6,2 786,4995000
Såld 7 februari 2019,Furuvägen 1,"Diseröd,",108,32,140,5,742,2795000
Såld 7 februari 2019,Prejelvägen 112,"Centrum,",142,5,147,5,382,5300000
Såld 4 februari 2019,Hallsbrovägen  14,"Kärna,",145,61,206,6,2 108,3700000
Såld 1 februari 2019,Nämndemansvägen  12,"Ytterby,",152,6,158,6,680,3895000
Såld 1 februari 2019,Lyckevägen 3,"Kärna,",120,72,192,5,2 857,3770000
Såld 1 februari 2019,Häradsvägen 24,"Ytterby,",130,5,135,5,342,3387500
Såld 30 januari 2019,Backsippegatan  4,"Ytterby - Tornhaga,",115,5,120,5,577,3300000
Såld 30 januari 2019,Rishammar 262,"Kareby,",186,6,192,6,5 205,4550000
Såld 27 januari 2019,Vitsippegatan 4,"Ytterby - Tornhaga,",189,8,197,8,626,4700000
Såld 24 januari 2019,Galeasgatan 17,"Centrum,",189,100,289,6,574,5425000
Såld 22 januari 2019,Vältvägen 509,"Ullstorp,",105,4,109,4,319,4550000
Såld 21 januari 2019,Gategården 250,"Hålta,",140,26,166,5,1 500,3990000
Såld 21 januari 2019,Rondan 37,"Ödsmåls mosse/Rörtången,",80,4,84,4,1 617,2850000
Såld 20 januari 2019,Kantorvägen 3,"Diseröd centrum,",165,14,179,5,761,4100000
Såld 19 januari 2019,Hemvägen  15,"Romelanda,",119,19,138,5,398,3550000
Såld 18 januari 2019,Tvetgatan 43,"Tveten,",109,5,114,5,156,3450000
Såld 17 januari 2019,Rörmossevägen  120,"Bohuslän,",170,81,251,5,4 070,4575000
Såld 15 januari 2019,Parkgatan 11,"Bohuslän,",260,9,269,9,513,6700000
Såld 11 januari 2019,Kristiansborg 170,"Tjuvkil,",77,55,132,6,1 295,3700000
Såld 8 januari 2019,Vena 328,"Ytterby - Vena,",125,5,130,5,1 520,4100000
Såld 4 januari 2019,Bergkristallvägen 15,"Kode,",140,6,146,6,479,4330000
Såld 30 december 2018,Knaverstad-Ryr 590,"Aröd,",90,3,93,3,1 007,3000000
Såld 28 december 2018,Prästvägen 676,"Romelanda,",222,5,227,5,1 329,4150000
Såld 27 december 2018,Ranneberg  154,"Kärna,",165,4,169,4,2 381,5200000
Såld 20 december 2018,Ranneberg 155,"Kärna,",155,42,197,,2 299,4500000
Såld 20 december 2018,Skålldal 140,"Bohuslän,",266,42,308,8,1 036,4300000
Såld 19 december 2018,Mariedalsvägen 1,"Kode,",63,2,65,2,3 432,1825000
Såld 19 december 2018,Mårdgatan 22,"Kungälv Centralt,",158,6,164,6,940,5900000
Såld 18 december 2018,Enskiftegatan 5,"Ytterby,",194,7,201,7,884,4800000
Såld 18 december 2018,Kvarndalsvägen 8C,"Lökeberg,",155,5,160,5,1 659,7050000
Såld 17 december 2018,Broberg 190,"Tjuvkil,",67,4,71,4,1 755,2000000
Såld 16 december 2018,Källeröd 210,"Kareby,",121,159,280,5,2 455,2550000
Såld 12 december 2018,Alelyckans väg 12,"Aröd,",154,12,166,6,1 392,3950000
Såld 8 december 2018,Kristinedalsgatan 5,"Kungälv,",152,67,219,5,701,6650000
Såld 7 december 2018,Bollestad 152,"Ytterby,",169,74,243,7,1 762,4500000
Såld 7 december 2018,Lingonvägen 41,"Jordliden Munkegärde,",115,5,120,5,399,4275000
Såld 3 december 2018,Häradsvägen 62,"Ytterby,",130,7,137,7,390,3800000
Såld 1 december 2018,Hammar 375,"Bohuslän,",98,65,163,6,2 371,4630000
Såld 29 november 2018,Skogsvägen  20,"Ingetorp,",101,5,106,5,1 318,2715000
Såld 29 november 2018,Harkeröd 310,"Hålta,",71,59,130,5,1 245,3050000
Såld 28 november 2018,Prästbol 165,"Aröd,",171,6,177,6,2 805,5700000
Såld 27 november 2018,Duvesjön 374,"Duvesjön,",110,4,114,4,1 000,3590000
Såld 26 november 2018,Ulvebackegatan 28,"Bohuslän,",128,32,160,6,793,4750000
Såld 23 november 2018,Hammar 310,"Bohuslän,",124,5,129,5,1 035,3200000
Såld 23 november 2018,Rostock 364,"Romelanda,","140,4",5,,5,1 148,5100000
Såld 23 november 2018,Stenåldersgatan 6,"Ytterby,",104,4,108,4,318,3725000
Såld 21 november 2018,Torp 310,"Kareby,",149,78,227,6,3 051,4300000
Såld 21 november 2018,Tyftervägen 20,"Bohuslän,",154,13,167,5,572,4300000
Såld 20 november 2018,Harkvägen 357,"Ullstorp,",111,4,115,4,572,5000000
Såld 18 november 2018,Grindklykan 27,"Grinden,",112,4,116,4,546,4400000
Såld 18 november 2018,Häggvägen 10,"Ytterby,",101,101,202,5,851,4170000
Såld 18 november 2018,Hemmansgatan 11,"Tega,",133,11,144,5,756,3900000
Såld 14 november 2018,Komministergatan 3,"Kungälv - Centrum,",120,80,200,7,678,5950000
Såld 12 november 2018,Djupuddsvägen  30,"Instön,",135,15,150,3,1 336,4800000
Såld 9 november 2018,Staby 130,"Kärna,",109,82,191,5,9 529,4020000
Såld 9 november 2018,Munkegärdegatan 253,"Munkegärde,",134,110,244,7,899,5750000
Såld 9 november 2018,Rosenstensvägen 6,"Kode,",123,5,128,5,485,3700000
Såld 5 november 2018,Nerebyskogens väg 14,"Kärna - Harestad,",33,2,35,2,1 821,1380000
Såld 1 november 2018,Bergåsvägen 22,"Ytterby,",153,40,193,7,710,4500000
Såld 30 oktober 2018,Nordängen 10,"Sundhammar,",174,16,190,5,1 331,4900000
Såld 29 oktober 2018,Apelviksgatan 7,"Centrum,",125,125,250,5,445,4750000
Såld 29 oktober 2018,Ranneberg 170,"Romelanda,",90,4,94,4,1 265,1960000
Såld 28 oktober 2018,Vesslegatan 3,"Olseröd,",131,12,143,4,376,4500000
Såld 26 oktober 2018,Bärnstensvägen 6,"Kode,",93,92,185,5,1 009,3250000
Såld 26 oktober 2018,Solvagnsgatan 7,"Kungälv,",137,8,145,6,362,5175000
Såld 25 oktober 2018,Hallsbrovägen 3,"Bohuslän,",74,3,77,3,1 801,2500000
Såld 24 oktober 2018,Tjäderstigen 8,"Centralt - Kungälv,",126,4,130,4,362,4300000
Såld 23 oktober 2018,Tegskiftegatan 50,"Ytterby,",112,57,169,5,856,4000000
Såld 22 oktober 2018,Fontinvägen 12,"Centralt - Kungälv,",231,9,240,9,1 269,6600000
Såld 19 oktober 2018,Skårby station 355,"Kareby,",150,4,154,4,2 260,4140000
Såld 18 oktober 2018,Häljeröd 120,"Romelanda Diseröd,",193,5,198,5,15 148,6100000
Såld 17 oktober 2018,Ellesbovägen 204,"Kungälv,",75,48,123,5,1 062,3000000
Såld 15 oktober 2018,Olserödsgatan 106,"Olseröd,",170,20,190,5,1 227,6000000
Såld 12 oktober 2018,Äslingsvägen 7,"Tjuvkil,",120,5,125,5,1 285,4100000
Såld 11 oktober 2018,Åsebyberg 855,"Kode,",129,18,147,5,4 105,3850000
Såld 5 oktober 2018,Solvagnsgatan 30,"Stället,",138,5,143,5,479,5275000
Såld 4 oktober 2018,Guntorpsvägen 24,"Kode,",110,100,210,5,1 065,2975000
Såld 3 oktober 2018,Lerlycke 250,"Kärna,",130,88,218,5,1 020,3700000
Såld 2 oktober 2018,Olvonvägen 23,"Diseröd,",222,98,320,7,1 000,3600000
Såld 28 september 2018,Bockebergsvägen 2,"Lycke,",49,10,59,4,1 386,1850000
Såld 27 september 2018,Lerskärsvägen 21,"Tjuvkil,",120,40,160,4,1 299,4700000
Såld 27 september 2018,Valtersäng 35,"Centralt,",159,40,199,6,650,6120000
Såld 25 september 2018,Råckeröd 200,"Kärna,",120,5,125,5,1 192,3150000
Såld 25 september 2018,Västra gatan 26A,"Centralt,",149,21,170,6,316,5500000
Såld 24 september 2018,Gamla Kungälvsvägen 13,"Ytterby,",176,87,263,8,1 862,6800000
Såld 19 september 2018,Havregången 12,"Kungälv centralt,",125,5,130,5,496,4000000
Såld 13 september 2018,Lerskärsvägen 50,"Lycke,",93,93,186,5,1 221,3750000
Såld 11 september 2018,Rubinvägen 6,"Kode,",108,114,222,5,1 123,3650000
Såld 11 september 2018,Bastubäcksvägen 11,"Ödsmåls mosse/Rörtången,",78,15,93,3,1 225,3100000
Såld 10 september 2018,Glose 110,"Glose,",150,30,180,5,3 157,4500000
Såld 9 september 2018,Bokvägen 3,"Kungälv centralt, Fontin.,",184,128,312,8,781,5350000
Såld 8 september 2018,Livelycke 290,"Bohuslän,",163,6,169,6,2 941,3820000
Såld 6 september 2018,Lilla Dalvägen 5,"Ödsmålsmosse,",36,2,38,2,1 667,965000
Såld 5 september 2018,Grepvägen 403,"Ullstorp,",121,5,126,5,526,5250000
Såld 5 september 2018,Vävra 380,"Hålta,",49,2,51,2,1 514,2260000
Såld 5 september 2018,Stenåldersgatan 11,"Ytterby,",103,4,107,4,440,3900000
Såld 4 september 2018,Storskiftegatan 11,"Ytterby,",90,40,130,4,188,3375000
Såld 3 september 2018,Vältvägen 505,"Bohuslän,",121,9,130,5,250,4800000
Såld 31 augusti 2018,Lilla Fjellsholmen 14,"Lilla Fjellsholmen,",86,4,90,4,418,6700000
Såld 30 augusti 2018,Hammarhöjden 695,"Kode,",83,28,111,3,1 053,2750000
Såld 30 augusti 2018,Kärnavägen 16,"Kärna,",171,83,254,7,695,4120000
Såld 30 augusti 2018,Klintegatan 17,"Centralt - Kungälv,",125,51,176,7,704,7350000
Såld 30 augusti 2018,Stenåldersgatan 53,"Ytterby - Stället,",107,5,112,5,381,4050000
Såld 29 augusti 2018,Grepvägen 391,"Ullstorp,",121,7,128,5,431,4850000
Såld 29 augusti 2018,Duvesjön 310,"Duvesjön,",101,4,105,4,1 454,2800000
Såld 29 augusti 2018,Torsby 132,"Kärna,",169,7,176,7,1 731,4550000
Såld 25 augusti 2018,Kristinedalsgatan 7,"Centrum,",178,85,263,6,857,7125000
Såld 24 augusti 2018,Åsebyberg 745,"Åsebyberg,",110,4,114,4,1 776,1130000
Såld 24 augusti 2018,Korpvägen 259,"KUNGÄLV,",139,18,157,6,437,5500000
Såld 17 augusti 2018,Ställets bygata 76,"YTTERBY,",147,6,153,6,1 070,4925000
Såld 15 augusti 2018,Skeppsholmsgatan 2,"Centrum,",121,5,126,5,913,6300000
Såld 10 augusti 2018,Jägersberg 244,"Kode,",120,3,123,3,2 003,3850000
Såld 9 augusti 2018,Hammarhöjden 670,"Kode,",100,47,147,2,1 090,3230000
Såld 29 juli 2018,Saltskärsvägen 10,"Tjuvkil,",64,2,66,2,3 440,2300000
Såld 26 juli 2018,Duvesjön 313,"Duvesjön,",87,3,90,3,1 191,3300000
Såld 18 juli 2018,Byvägen 18,"Ödsmåls mosse/Rörtången,",60,42,102,4,1 509,1850000
Såld 17 juli 2018,Guntorpsvägen 2,"Kode,",129,70,199,7,734,3150000
Såld 12 juli 2018,Tjuvkil 510,"Tjuvkil,",90,98,188,4,2 575,2550000
Såld 10 juli 2018,Lundby 475,"Kareby,",141,5,146,5,2 024,4680000
Såld 9 juli 2018,Gunneröd 200,"Lycke,",58,25,83,2,789,2400000
Såld 7 juli 2018,Bufferöd 150,"Kungälv - Hålta,",130,130,260,6,1 209,4550000
Såld 6 juli 2018,Bäckliden 6A,"Bohuslän,",116,6,122,6,880,5710000
Såld 6 juli 2018,Dösebacka 310,"Romelanda,",102,97,199,4,949,3450000
Såld 6 juli 2018,Tegskiftegatan 20,"Ytterby,",102,102,204,6,969,4525000
Såld 1 juli 2018,Fjällsholmen 360,"KÄRNA,",62,3,65,3,1 780,3110000
Såld 30 juni 2018,Glöskär 640,"Bohuslän,",72,3,75,3,3 456,3800000
Såld 21 juni 2018,Skårby mosse 930,"Kareby,",167,20,187,7,1 299,3800000
Såld 21 juni 2018,Lundby 502,"Kareby,",137,4,141,4,4 214,4550000
Såld 15 juni 2018,Helgonagatan 50,"Munkegärde,",117,4,121,4,2 003,3890000
Såld 15 juni 2018,Heavägen 15,"Lycke,",177,6,183,6,2 041,5000000
Såld 15 juni 2018,Klåverön 460,"Marstrand,",76,76,152,4,2 303,4300000
Såld 14 juni 2018,Dannemarksgatan 42,"Ytterby,",148,6,154,6,641,4800000
Såld 13 juni 2018,Dösebacka 630,"Diseröd,",84,84,168,4,1 407,2000000
Såld 13 juni 2018,Bergsgatan 2,"Marstrand - Koön,",118,82,200,6,892,8600000
Såld 10 juni 2018,Flateby 120,"Kärna,",167,6,173,6,2 039,3150000
Såld 8 juni 2018,Väktaregatan 9,"Bohuslän,",166,83,249,8,538,5300000
Såld 7 juni 2018,Lundby 220,"Kareby,",146,45,191,5,1 943,4650000
Såld 6 juni 2018,Bremnäs 450,"Lycke,",52,2,54,2,1 616,2400000
Såld 5 juni 2018,Skrivarevägen 6,"Tunge,",104,4,108,4,162,3400000
Såld 4 juni 2018,Gunneröd 130,"Lycke,",47,2,49,2,1 333,1700000
Såld 3 juni 2018,Bastövägen 12,"Kärna,",80,80,160,6,1 024,4200000
Såld 2 juni 2018,Kuskalundsvägen 39,"Bohuslän,",59,13,72,3,1 745,2270000
Såld 2 juni 2018,Korpedalsvägen 3,"Aröd,",115,85,200,5,993,3720000
Såld 1 juni 2018,Nämndemansvägen 13,"Ytterby,",141,7,148,7,939,4700000
Såld 31 maj 2018,Knaverstad-Ryr 450,"Kode,",44,3,47,3,885,1500000
Såld 31 maj 2018,Fjällsholmen 190,"Marstrand,",80,4,84,4,2 750,5200000
Såld 30 maj 2018,Järpstigen 2,"Skälebräcke,",128,5,133,5,743,4675000
Såld 30 maj 2018,Solberga 790,"Kode,",70,60,130,4,1 380,3550000
Såld 29 maj 2018,Kulperödsvägen 31,"Gullbringa,",148,5,153,5,2 678,1500000
Såld 25 maj 2018,Vrångholmen 150,"Marstrand/Kråkerön,",185,34,219,6,2 207,11000000
Såld 25 maj 2018,Hemmansgatan 7,"Ytterby,",155,6,161,6,875,4500000
Såld 24 maj 2018,Bäckvägen 10,"Lökeberg,",55,5,60,4,1 091,3910000
Såld 22 maj 2018,Rörmossevägen 240,"Rörmossen,",58,15,73,3,5 170,2215000
Såld 22 maj 2018,Lievägen 228,"Kungälv Ullstorp,",125,10,135,4,250,4750000
Såld 22 maj 2018,Lökebergsvägen 18,"Lökeberg,",110,65,175,4,55 368,6225000
Såld 17 maj 2018,Hermansby 228,"Kärna,",165,58,223,5,1 503,5825000
Såld 17 maj 2018,Gräsgången 6,"Kungälv,",125,4,129,4,514,3900000
Såld 17 maj 2018,Gategården 260,"Risby/Hålta,",120,71,191,5,2 337,5020000
Såld 16 maj 2018,Brunnefjäll 110,"Kärna,",121,185,306,6,2 124,3750000
Såld 16 maj 2018,Sandvik 110,"HARESTAD,",153,36,189,5,998,3400000
Såld 14 maj 2018,Galeasgatan 15,"Kungälv,",103,64,167,5,610,3500000
Såld 7 maj 2018,Fasanstigen 8,"Skälebräcke,",128,5,133,5,362,4250000
Såld 7 maj 2018,Brunnefjäll 190,"Kärna,",83,50,133,4,1 536,2810000
Såld 6 maj 2018,Enekullsvägen 32,"Ytterby,",101,20,121,4,807,3570000
Såld 3 maj 2018,Dannemarksgatan 39,"Ytterby,",159,32,191,6,730,4000000
Såld 2 maj 2018,Byvägen 22,"Ödsmålsmosse,",43,24,67,3,1 930,2500000
Såld 30 april 2018,Rådmansgatan 4,"Centrum,",220,6,226,6,678,6175000
Såld 19 april 2018,Bäck 250,"Romelanda,",49,2,51,2,7 867,1400000
Såld 19 april 2018,Rubinvägen 29,"KODE,",195,0,195,,746,4200000
Såld 6 april 2018,Bokvägen 5,"Kungälv centralt,",89,89,178,5,635,4450000
Såld 5 april 2018,Gategården 182,"Hålta,",240,50,290,8,1 484,4020000
Såld 1 april 2018,Valtersäng 11,"Kungälv Centralt,",162,0,162,,808,5495000
Såld 30 mars 2018,Harkeröd,"Hålta,",98,3,101,3,818,795000
Såld 29 mars 2018,Ulvesund 420,"Ytterby - Ulvesund,",47,2,49,2,1 043,1650000
Såld 29 mars 2018,Hallebäcksvägen 2,"Timmervik,",73,7,80,3,1 029,2550000
Såld 27 mars 2018,Snäckvägen 11,"Ödsmåls mosse/Rörtången,",45,25,70,2,1 593,2000000
Såld 24 mars 2018,Bergkristallvägen 1,"Kode,",132,5,137,5,501,4300000
Såld 23 mars 2018,Hög 110,"Diseröd,",241,9,250,9,2 835,4250000
Såld 20 mars 2018,Rishammarvägen 32,"Kareby,",122,61,183,5,794,4750000
Såld 16 mars 2018,Svärdgatan 8,"Ytterby,",137,8,145,5,428,5250000
Såld 11 mars 2018,Rörmossevägen 140,"Rörmossen,",174,6,180,6,1 407,4810000
Såld 10 mars 2018,Dotorp 400,"Kärna,",114,54,168,5,5 650,4200000
Såld 9 mars 2018,Skomakarevägen 17,"Hålta,",178,24,202,6,2 018,3730000
Såld 9 mars 2018,Havregången 1,"Komarken,",147,6,153,6,504,3900000
Såld 7 mars 2018,Åldermansvägen 4,"Ytterby,",130,125,255,7,695,4700000
Såld 27 februari 2018,Jorsalagatan 1,"Iskällan,",119,97,216,7,891,4300000
Såld 26 februari 2018,Prästvägen 830,"Diseröd,",259,48,307,10,3 049,6250000
Såld 23 februari 2018,Länsmansvägen 24,"Ytterby,",126,85,211,4,915,4600000
Såld 21 februari 2018,Rättarevägen 11,"Ytterby,",105,122,227,6,477,4780000
Såld 21 februari 2018,Västerhöjdsvägen 44,"Bohuslän,",104,15,119,6,285,4250000
Såld 20 februari 2018,Hemvägen 15,"Diseröd,",138,5,143,5,285,3450000
Såld 14 februari 2018,Grindvakten 31,"Grinden,",121,5,126,5,448,3700000
Såld 9 februari 2018,Skardet 126,"Kode,",212,7,219,7,2 456,6500000
Såld 8 februari 2018,Arntorp 190,"Kareby,",85,92,177,4,1 048,2735000
Såld 3 februari 2018,Solskiftegatan 38,"Ytterby,",110,50,160,5,797,4560000
Såld 3 februari 2018,Torsbyvägen 22,"Ytterby,",170,53,223,7,1 650,4800000
Såld 1 februari 2018,Flintstensgatan 1,"Ytterby - Stället,",122,5,127,5,304,4400000
Såld 30 januari 2018,Duvesjön 304,"Duvesjön,",124,4,128,4,1 180,3650000
Såld 30 januari 2018,Hemvägen 9,"Diseröd,",137,5,142,5,438,3500000
Såld 26 januari 2018,Poppelvägen 1,"Diseröd,",138,6,144,6,788,4500000
Såld 26 januari 2018,Fasanstigen 5,"Skälebräcke,",126,5,131,5,362,3495000
Såld 22 januari 2018,Rostock 338,"Bohuslän,",161,6,167,6,1 083,5000000
Såld 19 januari 2018,Prejelvägen 128,"Ullstorp,",122,5,127,5,293,4650000
Såld 14 januari 2018,Kolonigatan 6,"Marstrand,",135,75,210,5,863,8300000
Såld 12 januari 2018,Signehög 210,"Romelanda,",142,28,170,6,945,3350000
Såld 12 januari 2018,Munkegärdegatan 339,"Munkegärde,",117,5,122,5,659,4750000
Såld 3 januari 2018,Nordängen 2,"Sundhammar,",165,7,172,6,1 936,6500000
Såld 2 januari 2018,Kristiansborg 350,"Tjuvkil,",121,65,186,5,1 099,5500000
Såld 22 december 2017,Duvesjön 180,"Duvesjön,",47,2,49,2,1 650,1725000
Såld 21 december 2017,Råckeröd 150,"Kärna,",60,3,63,3,2 095,2195000
Såld 20 december 2017,Ulvesund 530,"Ytterby - Ulvesund,",75,20,95,4,3 233,3045000
Såld 13 december 2017,Prejelvägen 117,"Ullstorp,",122,8,130,5,596,4740000
Såld 13 december 2017,Krappvägen 571,"KUNGÄLV,",148,10,158,5,382,6000000
Såld 10 december 2017,Oskarsberg 120,"Kungälv Kareby,",208,5,213,5,1 363,4200000
Såld 7 december 2017,Vandilgatan 4,"Ytterby - Stället,",197,6,203,6,885,5750000
Såld 6 december 2017,Fasanstigen 10,"Skälebräcke,",128,4,132,4,338,4000000
Såld 2 december 2017,Lefstad 230,"Kärna,",93,93,186,7,1 603,3580000
Såld 29 november 2017,Prejelvägen 137,"Bohuslän,",122,10,132,5,423,4850000
Såld 27 november 2017,Plogvägen 191,"Ullstorp,",122,"26,5",,5,402,4800000
Såld 24 november 2017,Västra gatan 40,"Centralt,",133,50,183,6,1 096,6350000
Såld 23 november 2017,Sjöhåla 580,"Kovikshamn,",94,87,181,5,1 068,3100000
Såld 18 november 2017,Galeasgatan 15,"Kungälv,",103,64,167,5,610,3850000
Såld 17 november 2017,Västerhöjdsvägen 36,"Kärna,",107,5,112,5,258,4000000
Såld 16 november 2017,Gråstensvägen 19,"Kode Halltorp,",94,5,99,5,1 197,3200000
Såld 16 november 2017,Hägnan 135,"KAREBY,",235,6,241,6,104 335,8800000
Såld 15 november 2017,Rishammarvägen 17,"Kareby,",120,80,200,6,1 142,4375000
Såld 10 november 2017,Nygatan 14,"Marstrand - Koön,",167,80,247,6,677,10800000
Såld 5 november 2017,Granndalen 7,"Lycke,",50,2,52,2,1 465,1875000
Såld 1 november 2017,Skårby 670,"Kareby,",143,6,149,6,4 813,3000000
Såld 1 november 2017,Kodevägen 3,"KODE,",150,50,200,7,2 025,4300000
Såld 31 oktober 2017,Matskärsvägen 12A,"Lycke,",145,6,151,6,249,4500000
Såld 31 oktober 2017,Årsnäs 290,"Årsnäs,",167,5,172,5,2 558,4950000
Såld 27 oktober 2017,Staby 350,"Kärna,",110,80,190,4,911,2425000
Såld 27 oktober 2017,Vråstigen 6,"Överön / Vråkärr,",100,3,103,3,1 453,2475000
Såld 26 oktober 2017,Bergkristallvägen 23,"Kode,",130,5,135,5,504,4780000
Såld 23 oktober 2017,Östra Gatan 9,"Centrum,",325,82,407,10,359,7900000
Såld 21 oktober 2017,Kållen 160,"Norrmannebo,",88,4,92,4,1 819,1650000
Såld 20 oktober 2017,Fredkullagatan 8,"Komarken,",175,100,275,6,741,7160000
Såld 20 oktober 2017,Jakobsvägen 7,"Kode,",188,3,191,3,1 324,5475000
Såld 16 oktober 2017,Mjölnarvägen 13,"Diseröd,",158,59,217,7,899,3965000
Såld 13 oktober 2017,Klövergången 15,"Centrum,",125,4,129,4,401,4150000
Såld 13 oktober 2017,Kulperödsvägen 5A,"Gullbringa,",100,20,120,5,450,2495000
Såld 13 oktober 2017,Stora Ryr 130,"Lycke,",80,20,100,5,2 270,1600000
Såld 12 oktober 2017,Röd 140,"Kareby,",122,11,133,4,2 052,3400000
Såld 12 oktober 2017,Smaragdvägen 48,"Kode,",133,5,138,5,368,3700000
Såld 10 oktober 2017,Ulvesund 405,"Ytterby - Ulvesund,",72,3,75,3,681,2670000
Såld 9 oktober 2017,Åsebyberg 853,"Åseby,",137,5,142,5,1 462,4150000
Såld 6 oktober 2017,Toftebergsvägen 2,"Tjuvkil,",84,"3,5",,"3,5",1 085,3700000
Såld 5 oktober 2017,Kärnavägen 4,"Kärna,",110,90,200,7,860,4100000
Såld 5 oktober 2017,Enekullsvägen 28,"Enekullen,",125,18,143,4,789,4100000
Såld 3 oktober 2017,Skårshöjd 8,"Kärna,",120,40,160,5,900,2700000
Såld 2 oktober 2017,Lundby 280,"Kareby 1,",85,4,89,4,2 056,3250000
Såld 29 september 2017,Rosenstensvägen 3,"Kode,",143,6,149,6,458,4000000
Såld 25 september 2017,Bräcke 330,"Kärna,",86,4,90,4,1 188,2800000
Såld 22 september 2017,Ulvesund 419,"Kungälv - Ulvesund,",65,2,67,2,688,2710000
Såld 21 september 2017,Bergåsvägen 23,"Ytterby,",131,37,168,5,1 267,4575000
Såld 20 september 2017,Vävra 710,"Hålta,",100,100,200,5,4 794,3650000
Såld 20 september 2017,Trätäljagatan 2,"Iskällan,",147,147,294,9,937,5875000
Såld 14 september 2017,Håkons gata 6,"Iskällan,",117,4,121,4,960,4950000
Såld 10 september 2017,Torp 340,"Kareby,",127,100,227,6,21 023,4325000
Såld 8 september 2017,Västra Åkerhögsvägen 17,"Kärna,",155,20,175,6,1 824,4575000
Såld 7 september 2017,Rävo 170,"Hålta,",165,60,225,5,4 627,7150000
Såld 7 september 2017,Törnrosgatan 5,"Ytterby Tornhaga,",195,6,201,6,1 075,4555000
Såld 5 september 2017,Snäckliden 13,"Sundhammar,",48,33,81,4,1 590,2800000
Såld 1 september 2017,Bergåsvägen 16e,"Kungälv - Ytterby,",100,4,104,4,602,4820000
Såld 31 augusti 2017,Sjöhåla 170,"KÄRNA,",124,72,196,5,2 035,3550000
Såld 30 augusti 2017,Duvesjön 308,"Romelanda,",121,4,125,4,916,3295000
Såld 29 augusti 2017,Hermelingatan 11,"Olseröd,",126,5,131,5,548,5300000
Såld 28 augusti 2017,Flädervägen 14,"Bohuslän,",105,5,110,5,476,3450000
Såld 24 augusti 2017,Solberga 900,"Kode,",123,4,127,4,1 107,2500000
Såld 24 augusti 2017,Åseby Österväg 9,"Åsebyberg,",200,6,206,6,1 288,4650000
Såld 24 augusti 2017,Sköldgatan 9,"YTTERBY,",136,28,164,4,490,5250000
Såld 23 augusti 2017,Klåverön 580,"Marstrand,",90,30,120,5,21 929,21000000
Såld 23 augusti 2017,Honeröd 280,"Bohuslän,",120,4,124,4,10 004,3750000
Såld 23 augusti 2017,Stora Risby 530,"Hålta,",62,53,115,4,925,2900000
Såld 23 augusti 2017,Akvamarinvägen 7,"Kode,",112,5,117,5,779,3130000
Såld 22 augusti 2017,Heavägen 21,"Lycke,",140,40,180,5,2 355,3775000
Såld 21 augusti 2017,Skårby mosse 860,"Kareby,",164,6,170,6,2 621,3525000
Såld 18 augusti 2017,Husfrejagatan 7,"Iskällan,",124,151,275,8,984,7150000
Såld 16 augusti 2017,Ljungvägen 20,"Ödsmålsmosse vid Rörtången,",34,2,36,2,650,925000
Såld 15 augusti 2017,Staby (770),"Kärna,",117,5,122,5,1 000,3990000
Såld 9 augusti 2017,Bergsgatan 7,"Marstrand,",265,67,332,7,729,10500000
Såld 8 augusti 2017,Smugglaregatan 14,"Marstrandsön,",133,91,224,6,744,16000000
Såld 4 augusti 2017,Hallbjörtorp 370,"Kungälv - Kärna,",30,30,60,2,1 535,2425000
Såld 2 augusti 2017,Tullaregatan 5,"Marstrandsön,",190,6,196,6,371,13200000
Såld 29 juli 2017,Stadsängsvägen 4,"Marstrand-Instön,",72,3,75,3,1 489,4150000
Såld 25 juli 2017,Länsmansvägen 8,"Ytterby,",124,124,248,4,1 369,6250000
Såld 18 juli 2017,Fontinvägen 20,"Kungälv - Centrum,",220,50,270,5,1 034,6100000
Såld 17 juli 2017,Enekullsvägen 54B,"Ytterby - Enekullen,",176,6,182,6,930,4600000
Såld 17 juli 2017,Olsåker 110,"Kareby,",139,60,199,8,16 226,5200000
Såld 12 juli 2017,Prejelvägen 102,"Ullstorp,",122,6,128,5,304,4800000
Såld 11 juli 2017,Ulvesund 427,"KUNGÄLV - Ulvesund,",100,10,110,5,939,3850000
Såld 11 juli 2017,Sävstigen 2,"Centralt,",121,1,122,5,534,3800000
Såld 8 juli 2017,Solberg 455,"Romelanda,",,,0,,534,2000000
Såld 8 juli 2017,Solberg 460,"Romelanda,",5,0,5,5,534,3000000
Såld 7 juli 2017,Nedre Knaverstad 280,"Aröd,",99,15,114,4,2 105,3300000
Såld 5 juli 2017,Oxelvägen 84,"Diseröd,",139,5,144,5,433,4200000
Såld 28 juni 2017,Hammarberg 840,"Kode,",67,3,70,3,1 893,1950000
Såld 22 juni 2017,Röd 140,"Kareby,",150,4,154,4,2 052,3730000
Såld 21 juni 2017,Djupuddsvägen 6,"Marstrand-Instön,",120,88,208,5,2 346,4800000
Såld 16 juni 2017,Jakobsvägen 25,"Aröd,",75,25,100,4,1 454,4150000
Såld 15 juni 2017,Ripstigen 5,"Centrum,",128,4,132,4,362,3850000
Såld 15 juni 2017,Klåverön 290,"Marstrand,",70,3,73,3,986,5700000
Såld 14 juni 2017,Häradsvägen 18,"Ytterby,",128,10,138,5,342,4500000
Såld 14 juni 2017,Ulvedalsgatan 10,"Ulvegärde,",157,5,162,5,1 031,4630000
Såld 14 juni 2017,Hällristningsgatan 15,"YTTERBY,",107,5,112,5,430,5185000
Såld 9 juni 2017,Grindbacken 20,"Grinden,",148,44,192,7,903,6075000
Såld 8 juni 2017,Åsebyberg 925,"Kungälvs kommun,",177,57,234,6,2 837,4750000
Såld 8 juni 2017,Mossvägen 41,"Lökeberg,",46,2,48,2,1 413,2160000
Såld 4 juni 2017,Ulvesund 405,"Ytterby - Ulvesund,",72,3,75,3,681,2750000
Såld 3 juni 2017,Lökebergsvägen 61,"Marstrand,",140,50,190,6,22 000,12000000
Såld 2 juni 2017,Staby 760,"Kärna,",210,90,300,10,6 203,5500000
Såld 2 juni 2017,Saltskärsvägen 6,"Tjuvkil,",46,3,49,3,1 474,2150000
Såld 2 juni 2017,Hallebäcksvägen 31,"Aröd/Timmervik,",75,18,93,3,1 470,2250000
Såld 2 juni 2017,Klövergången 10,"KUNGÄLV,",120,10,130,4,407,3700000
Såld 1 juni 2017,Grindenvägen 27,"Grinden,",165,65,230,7,925,5205000
Såld 1 juni 2017,Duvesjön 465,"Romelanda-Duvesjön,",36,4,40,2,1 586,1150000
Såld 31 maj 2017,Enskiftegatan 10,"Ytterby,",179,6,185,6,768,4850000
Såld 29 maj 2017,Duvesjön 212,"Duvesjön,",49,2,51,2,1 442,1750000
Såld 28 maj 2017,Rishammar 250,"Kareby,",104,90,194,6,1 215,3750000
Såld 26 maj 2017,Dalvägen 17,"Ödsmåls mosse/Rörtången,",45,40,85,5,1 036,2395000
Såld 25 maj 2017,Skrivarevägen 46,"Ytterby,",104,4,108,4,176,3400000
Såld 25 maj 2017,Fredkullagatan 21,"Centrum,",130,130,260,7,978,5710000
Såld 25 maj 2017,Årsnäs 460,"Kode,",40,3,43,3,2 393,2450000
Såld 19 maj 2017,Husfrejagatan 6,"Iskällan,",152,52,204,6,938,5400000
Såld 17 maj 2017,Matskärsvägen 70,"Tjuvkil,",86,4,90,4,1 138,3470000
Såld 16 maj 2017,Västerhöjdsvägen 24,"Kärna,",150,15,165,6,728,5300000
Såld 15 maj 2017,Plogvägen 209,"Ullstorp,",122,5,127,5,290,4800000
Såld 14 maj 2017,Byvägen 63,"Ödsmålsmosse vid Rörtången,",104,5,109,5,1 750,3300000
Såld 12 maj 2017,Myrstigen 4,"Tjuvkil/Lökeberg,",56,2,58,2,1 511,3240000
Såld 12 maj 2017,"Västra Trädal 205, Villa Kobbskär","Kärna Kållstorp,",127,5,132,5,1 236,4635000
Såld 10 maj 2017,Stora Risby 360,"Bohuslän,",43,3,46,3,1 264,1750000
Såld 10 maj 2017,Fregattgatan 2,"Kungälv,",217,26,243,7,781,4650000
Såld 8 maj 2017,Jakobsvägen 21-23,"Aröd,",95,65,160,5,2 963,4550000
Såld 5 maj 2017,Östergårdsgatan 63,"Ytterby,",150,6,156,6,1 556,5700000
Såld 5 maj 2017,Stora Lycke 330,"Kungälv - Lycke,",220,7,227,7,3 147,7000000
Såld 4 maj 2017,Tolleröd 115,"Kode,",120,100,220,7,2 130,4295000
Såld 2 maj 2017,Situlagatan 3,"YTTERBY,",154,16,170,6,795,5600000
Såld 1 maj 2017,Kvarndalsvägen 40,"Lökeberg,",56,36,92,3,1 089,2650000
Såld 29 april 2017,Skäggstorp 180,"Kode,",58,2,60,2,1 353,2360000
Såld 27 april 2017,Knapegården 170,"Kode,",62,3,65,3,1 256,1840000
Såld 27 april 2017,Briljantvägen 21,"Kode,",150,6,156,6,498,4350000
Såld 26 april 2017,Bergkristallvägen 21,"Kode,",127,10,137,6,531,4250000
Såld 26 april 2017,Mantalsgatan 29,"Ytterby,",193,6,199,6,882,5360000
Såld 25 april 2017,Vallhjonsgatan 14,"Marstrand - Koön,",172,6,178,6,630,8200000
Såld 25 april 2017,Bergkristallvägen 3,"Kode,",125,9,134,4,527,4500000
Såld 16 april 2017,Tryggvasons gata 1,"Iskällan,",135,40,175,7,785,6500000
Såld 16 april 2017,Snäckvägen 19,"Ödsmåls mosse/Rörtången,",90,17,107,4,1 184,3600000
Såld 10 april 2017,Sjöhåla 440,"Sjöhåla Torsby,",142,4,146,4,1 243,4250000
Såld 7 april 2017,Fontinvägen 42,"Centrum,",118,7,125,4,440,4600000
Såld 7 april 2017,Solberga 510,"Solberga-Kode,",98,58,156,5,1 517,2990000
Såld 30 mars 2017,Helgonagatan 175,"Munkegärde,",187,7,194,7,721,5150000
Såld 30 mars 2017,Gategården 257,"Bohuslän,",126,5,131,5,776,4700000
Såld 24 mars 2017,Skårby Station 395,"Kungälv - Kareby,",173,7,180,7,1 922,5095000
Såld 24 mars 2017,"Västra Trädal 215, Villa Solbacka","Kärna Kållstorp,",156,8,164,8,1 234,4600000
Såld 17 mars 2017,Västerhöjdsvägen 36,"Kärna,",107,5,112,5,258,4050000
Såld 16 mars 2017,Stenåldersgatan 12,"Ytterby Stället,",104,7,111,4,357,4000000
Såld 16 mars 2017,Lievägen 224,"Ullstorp,",122,5,127,5,304,4700000
Såld 15 mars 2017,Hövdingagatan 4,"Centrum,",115,137,252,7,906,5325000
Såld 11 mars 2017,Havregången 9,"Kungälv,",137,6,143,6,402,3700000
Såld 8 mars 2017,Hermansby 224,"Kärna,",178,6,184,6,1 494,5750000
Såld 7 mars 2017,Glose 380,"Kärna,",138,5,143,5,1 119,2900000
Såld 4 mars 2017,Dotorp 540,"Kärna,",85,5,90,5,1 214,3700000
Såld 3 mars 2017,Komministergatan 10,"Kungälv - Centrum,",145,125,270,9,659,6550000
Såld 2 mars 2017,Vävra 800,"Hålta,",148,18,166,9,6 109,4460000
Såld 2 mars 2017,Arntorp 220,"Kareby,",138,24,162,6,2 125,4200000
Såld 24 februari 2017,Rishammar 110,"Kareby,",140,19,159,6,1 205,3550000
Såld 24 februari 2017,Timmervik 150,"Romelanda - Dösebacka,",190,6,196,6,1 345,3510000
Såld 22 februari 2017,Kållstorp 125,"Kode,",70,4,74,4,12 437,3250000
Såld 22 februari 2017,Munkegärdegatan 31,"Munkegärde,",118,4,122,4,239,3870000
Såld 21 februari 2017,Mycklaborgsgatan 5,"Kungälv - Centralt,",140,20,160,5,664,3900000
Såld 18 februari 2017,Högsberg 320,"Kode,",80,32,112,2,1 114,2650000
Såld 16 februari 2017,Hövdingagatan 1,"Centrum,",163,160,323,6,1 030,5400000
Såld 16 februari 2017,Häljeröd 260,"Häljeröd,",137,99,236,5,909,2600000
Såld 15 februari 2017,Kuskalundsvägen 33,"Vävra,",83,13,96,4,1 519,3250000
Såld 13 februari 2017,Toreby Mosse 600,"Kungälv - Harestad,",104,16,120,4,1 622,3750000
Såld 9 februari 2017,Mycklaborgsgatan 6,"Kungälv - Centralt,",228,7,235,7,681,5120000
Såld 9 februari 2017,Oxelvägen 12,"Romelanda,",109,5,114,5,289,3455000
Såld 8 februari 2017,Hällristningsgatan 6,"Ytterby,",103,4,107,4,258,3350000
Såld 8 februari 2017,Poppelvägen 4,"Kungälv - Romelanda,",155,34,189,6,800,4000000
Såld 7 februari 2017,Skårby Station 500,"Kungälv - Kareby,",200,88,288,8,19 677,6200000
Såld 7 februari 2017,Staby 200,"KÄRNA,",132,72,204,5,1 032,2562000
Såld 6 februari 2017,Vena 295,"Ytterby - Vena,",154,5,159,5,3 152,4850000
Såld 3 februari 2017,Guddeby 272,"Ytterby,","168,5","37,5",,8,1 552,4700000
Såld 2 februari 2017,Grepvägen 397,"Kungälv,",148,6,154,6,424,5600000
Såld 26 januari 2017,Skårby Station 560,"Kareby,",115,118,233,7,1 269,3500000
Såld 26 januari 2017,Konvaljgatan 13,"Tornhaga,",115,5,120,5,701,3750000
Såld 25 januari 2017,Broberg 130,"Lycke,",120,5,125,5,2 400,4465000
Såld 22 januari 2017,Strömgatan 10,"Ytterby,",100,4,104,4,1 071,3610000
Såld 21 januari 2017,Hövdingagatan 5,"Kungälv - Centralt,",170,34,204,6,641,4740000
Såld 17 januari 2017,Briljantvägen 11,"Kode,",153,5,158,5,555,3800000
Såld 12 januari 2017,Hallsbergsvägen 6,"Kode,",139,10,149,5,3 353,3550000
Såld 4 januari 2017,Hallbjörtorp 290,"Kärna,",75,75,150,5,1 312,3300000
Såld 16 december 2016,Skvaltvägen 3,"Romelanda Diseröd,",180,145,325,8,1 352,3700000
Såld 9 december 2016,Västerhöjdsvägen 8,"Kärna,","81,6","43,2",,2,473,3200000
Såld 5 december 2016,Norra Arödsvägen 40,"Aröd,",55,3,58,3,1 584,2620000
Såld 2 december 2016,Östergårdsgatan 12,"Kungälv - Ytterby,",180,55,235,5,1 137,5460000
Såld 29 november 2016,Åseby 400,"Kungälv - Rörtången,",154,5,159,5,2 523,4550000
Såld 28 november 2016,Täljstensgatan 2,"Ytterby,",70,3,73,3,551,3000000
Såld 22 november 2016,Västra Gatan 35a,"Kungälv - Centrum,",214,44,258,8,344,6450000
Såld 18 november 2016,Parken 110,"Kode lantligt,",157,7,164,7,4 160,4510000
Såld 17 november 2016,Diserödsvägen 15,"Romelanda Diseröd,",114,105,219,7,719,3825000
Såld 12 november 2016,Gunneröd 460,"LYCKE,",87,45,132,3,1 067,2725000
Såld 11 november 2016,Storskiftegatan 100,"Ytterby,",135,6,141,6,782,4215000
Såld 4 november 2016,Rökgatan 9,"Centrum,",71,59,130,5,737,2950000
Såld 2 november 2016,Diamantvägen 52,"Kode,",156,6,162,6,557,4200000
Såld 1 november 2016,Väderhattsgatan 3,"Iskällan,",180,81,261,8,1 069,6030000
Såld 27 oktober 2016,Skårpedal 160,"Lycke,",122,70,192,5,1 643,3530000
Såld 27 oktober 2016,Kaprifolvägen 6,"Kärna,",128,5,133,5,524,3330000
Såld 26 oktober 2016,Vävra 495,"Vävra - Tjuvkil - Kungälv,",34,55,89,2,3 273,950000
Såld 20 oktober 2016,Oxelvägen 40,"Romelanda,",109,45,154,5,300,3460000
Såld 18 oktober 2016,Ulvebackegatan 6,"Bohuslän,",135,28,163,5,1 135,4400000
Såld 17 oktober 2016,Häljeröd 190,"Romelanda,",84,79,163,5,4 000,3400000
Såld 17 oktober 2016,Kornhall 210,"Harestad,",80,4,84,4,570,2200000
Såld 14 oktober 2016,Tröskvägen 270,"Ullstorp,",140,5,145,5,557,5700000
Såld 13 oktober 2016,Glöskär 300,"Kärna,",60,3,63,3,1 988,1400000
Såld 13 oktober 2016,Västerängen 17,"Ytterby,",143,37,180,6,825,4550000
Såld 12 oktober 2016,Solhultsgatan 20,"Centrum,",112,46,158,4,558,3830000
Såld 10 oktober 2016,Prästbol 165,"Aröd,",171,6,177,6,2 805,5400000
Såld 8 oktober 2016,Toftåsen 10,"Sundhammar,",70,3,73,3,1 961,2490000
Såld 8 oktober 2016,Solvagnsgatan 28,"Ytterby - Stället,",164,12,176,6,441,4725000
Såld 7 oktober 2016,Kärrhed 240,"Kärna,",48,2,50,2,2 760,2100000
Såld 5 oktober 2016,Sköldgatan 5,"Ytterby Stället,",137,8,145,5,437,4400000
Såld 30 september 2016,Signehög 210,"Kungälv - Romelanda,",142,6,148,6,945,3100000
Såld 29 september 2016,Hallsbrovägen 3,"Kärna,",60,2,62,2,1 801,1150000
Såld 29 september 2016,Lökebergsvägen 41,"Lökeberg,",44,6,50,2,1 511,2550000
Såld 29 september 2016,Domsvägen 3,"Ytterby,",157,99,256,6,921,4850000
Såld 25 september 2016,Plogvägen 180,"Kungälv,",106,5,111,,338,4300000
Såld 23 september 2016,Bärtas väg 13,"Ödsmålsmosse,",75,3,78,3,1 418,3250000
Såld 23 september 2016,Onyxvägen 19,"Kode,",155,7,162,7,557,4750000
Såld 17 september 2016,Lingonvägen 38,"Centralt,",127,5,132,5,428,4560000
Såld 14 september 2016,Djupuddsvägen 20,"Marstrand - Instön,",112,3,115,3,1 438,3500000
Såld 13 september 2016,Kastellegårdsgatan 47,"KUNGÄLV,",116,50,166,4,938,3425000
Såld 10 september 2016,Rosenstensvägen 41,"Kode,",135,0,135,,193,2800000
Såld 9 september 2016,Annas väg 25,"Kovikshamn,",62,22,84,3,1 026,2730000
Såld 2 september 2016,Knaverstad-Ryr 580,"Aröd,",158,4,162,6,1 012,2840000
Såld 1 september 2016,Solrosvägen 12,"Kärna,",135,96,231,8,818,3325000
Såld 30 augusti 2016,Bergåsvägen 16 C-D,"Ytterby,","175,5",6,,6,600,4700000
Såld 28 augusti 2016,Åkerhög 310,"Vedhall - Åkerhög,",65,3,68,3,1 500,2050000
Såld 26 augusti 2016,Skårby Mosse 870,"Bohuslän,",147,50,197,5,3 073,4000000
Såld 25 augusti 2016,Rörtången 126,"Rörtången,",170,20,190,5,1 638,8700000
Såld 24 augusti 2016,Sjöhåla Strandväg 14,"Kovikshamn,",164,4,168,4,1 075,5700000
Såld 20 augusti 2016,Tegskiftegatan 20,"YTTERBY,",102,102,204,5,969,3550000
Såld 18 augusti 2016,Bärtas väg 23,"Ödsmålsmosse,",51,20,71,3,1 380,3025000
Såld 15 augusti 2016,Långgatan 8,"Marstrandsön,",244,50,294,11,318,11250000
Såld 14 augusti 2016,Instölid 40,"Marstrand-Instön,",70,4,74,4,1 010,3500000
Såld 12 augusti 2016,Åsebyberg 847,"KODE,",120,15,135,4,1 163,3300000
Såld 8 augusti 2016,Bremnäs 305,"LYCKE,",115,4,119,4,1 979,4000000
Såld 28 juli 2016,Tröskvägen 256,"Ullstorp,",149,9,158,6,440,5355000
Såld 27 juli 2016,Östra röd 248,"HARESTAD,",144,0,144,,2 006,4200000
Såld 25 juli 2016,Stenstavägen 21,"Tjuvkil,",140,58,198,6,1 223,6000000
Såld 20 juli 2016,Rombacka 180,"Kareby,",53,7,60,2,2 031,1075000
Såld 18 juli 2016,Vedbackavägen 4 A + B,"Rödbo,",254,42,296,7,1 046,2900000
Såld 15 juli 2016,Lefstad 110,"Kärna,",182,8,190,8,2 630,2600000
Såld 15 juli 2016,Gunneröd 290,"Lycke,",132,39,171,4,2 125,2300000
Såld 13 juli 2016,Duvesjön 228,"Duvesjön,",121,37,158,5,1 150,3400000
Såld 11 juli 2016,Violgatan 7,"Ytterby,",139,36,175,7,588,4200000
Såld 10 juli 2016,Instölid 65,"Marstrand-Instön,",60,4,64,4,1 012,3320000
Såld 8 juli 2016,Rörtången 103,"Rörtången,",162,62,224,5,1 015,7250000
Såld 6 juli 2016,Nereby 360,"Kärna - Harestad,",120,40,160,6,1 149,3100000
Såld 6 juli 2016,Skår 260,"Romelanda Skår,",31,2,33,2,785,250000
Såld 5 juli 2016,Mariebergsvägen 130,"Östra Kungälv - Marieberg,",230,41,271,10,2 100,5520000
Såld 5 juli 2016,Lerlycke 240,"Lerlycke - Kärna,",129,44,173,3,12 665,4420000
Såld 4 juli 2016,Rörtången 295,"Kode,",90,15,105,4,1 795,5275000
Såld 4 juli 2016,Dannemarksgatan 45,"Tega,",140,5,145,5,1 072,4850000
Såld 4 juli 2016,Krokens Väg 11,"Tjuvkil,",148,6,154,6,1 155,6000000
Såld 1 juli 2016,Briljantvägen 9,"KODE,",125,5,130,5,350,3200000
Såld 28 juni 2016,Rörmossevägen 180,"Rörmossen,",110,135,245,6,1 827,3725000
Såld 26 juni 2016,Hammar 565,"Skäggstorp,",160,4,164,4,2 210,3000000
Såld 22 juni 2016,Byvägen 33,"Kode Ödsmål,",58,3,61,3,1 871,2625000
Såld 21 juni 2016,Alelyckans väg 23,"Kode,",80,100,180,5,37 080,9000000
Såld 19 juni 2016,Krokens Väg 16,"Tjuvkil,",67,50,117,4,1 590,3250000
Såld 14 juni 2016,Stenstavägen 1,"Tjuvkil,",125,32,157,5,800,3850000
Såld 14 juni 2016,Instölid 82,"MARSTRAND,",36,10,46,3,902,2320000
Såld 10 juni 2016,Rönnvägen 7,"Romelanda Diseröd,",122,82,204,7,796,3300000
Såld 8 juni 2016,Valler 300,"Valler - Romelanda,",185,52,237,7,2 497,3450000
Såld 6 juni 2016,Svartedalen 220,"Svartedalen-Björkärr,",30,3,33,3,1 774,685000
Såld 4 juni 2016,Fontinvägen 42,"Centrum,",118,7,125,4,440,5100000
Såld 3 juni 2016,Bokvägen 10,"Centrum,",125,27,152,5,635,4400000
Såld 2 juni 2016,Hermansby 150,"Kärna,",123,97,220,6,2 397,4070000
Såld 1 juni 2016,Duvesjön 348,"Kungälv -Duvesjön,",160,26,186,4,1 927,5200000
Såld 31 maj 2016,Granndalen 12,"Lycke,",65,2,67,2,1 217,2050000
Såld 31 maj 2016,Åsgatan 5,"Kungälv - Centrum,",120,60,180,6,948,5565000
Såld 31 maj 2016,Hemmansgatan 3,"Ytterby-Tega,",158,6,164,6,859,3855000
Såld 31 maj 2016,Jakobsvägen 27,"Aröd,",140,5,145,5,2 050,4850000
Såld 30 maj 2016,Olserödsgatan 114,"Kungälv - Olseröd,",144,132,276,7,712,5325000
Såld 27 maj 2016,Slånbärsvägen 15,"Munkegärde Östra,",145,31,176,5,647,5100000
Såld 26 maj 2016,Rosenstensvägen 33,"Kode,",112,4,116,4,620,3400000
Såld 26 maj 2016,Stinneröd 260,"Bohuslän,",65,65,130,4,1 734,1300000
Såld 26 maj 2016,Onyxvägen 22,"Kode lantligt,",123,5,128,5,566,3210000
Såld 26 maj 2016,Hällristningsgatan 26,"Ytterby Stället,",75,3,78,3,404,2995000
Såld 23 maj 2016,Duvesjön 371,"Romelanda-Duvesjön,",4,0,4,4,1 808,3600000
Såld 23 maj 2016,Mjölnarvägen 16,"Romelanda,",121,47,168,5,831,2385000
Såld 21 maj 2016,Lerskärsvägen 63,"Tjuvkil,",110,10,120,3,884,3875000
Såld 21 maj 2016,Briljantvägen 36,"Kode,",150,5,155,5,462,4100000
Såld 17 maj 2016,Jägarvägen 6,"Romelanda,",159,16,175,6,564,3625000
Såld 16 maj 2016,Plogvägen 174,"Ullstorp,",122,5,127,5,308,4175000
Såld 15 maj 2016,Brunnefjällsvägen 3,"Vedhall,",94,16,110,4,1 067,2695000
Såld 14 maj 2016,Toreby 380,"Harestad,",157,99,256,7,2 591,2902500
Såld 13 maj 2016,Hemvägen 25,"Romelanda - Diseröd,",138,19,157,5,381,3250000
Såld 12 maj 2016,Solskiftegatan 14,"Ytterby - Tega,",171,25,196,6,1 091,3900000
Såld 12 maj 2016,Marias Väg 2,"Aröd,",90,4,94,4,1 608,3400000
Såld 11 maj 2016,Almvägen 3,"Romelanda - Diseröd,",130,5,135,5,727,3300000
Såld 9 maj 2016,Solvagnsgatan 3,"Ytterby - Stället,",140,4,144,4,360,4300000
Såld 9 maj 2016,Skårby Mosse 880,"Skårby,","86,3",40,,4,1 782,2900000
Såld 6 maj 2016,Ugglehed 180,"Önneröd,",106,64,170,5,15 352,2730000
Såld 1 maj 2016,Vena 318,"Ytterby,",112,4,116,4,9 024,4100000
Såld 1 maj 2016,Duvesjön 225,"Romelanda,",65,3,68,3,1 800,1950000
Såld 29 april 2016,Duvesjön 201,"Duvesjön,",38,9,47,2,1 390,1300000
Såld 28 april 2016,Munkholmsgatan 2,"Centralt,",137,73,210,7,893,4900000
Såld 28 april 2016,Björkstigen 9,"Romelanda,",185,46,231,7,937,3700000
Såld 25 april 2016,Settungsvägen 62,"Ullstorp,",140,26,166,6,372,4450000
Såld 24 april 2016,Situlagatan 2,"Ytterby,",150,20,170,6,787,4500000
Såld 22 april 2016,Äslingsvägen 8,"Tjuvkil,",183,6,189,6,1 380,5650000
Såld 21 april 2016,Kärrhed 190,"Kärna,",122,4,126,4,1 316,2850000
Såld 14 april 2016,Olvonvägen 71,"Kungälv - Romelanda,",115,115,230,6,2 056,4725000
Såld 14 april 2016,Rättarevägen 16,"Ytterby,",105,122,227,6,732,4300000
Såld 12 april 2016,Ametistvägen 11,"Kode,",107,4,111,4,806,2850000
Såld 9 april 2016,Rådalsvägen 25 Havsutsikt,"Aröd,",88,3,91,3,1 462,2995000
Såld 8 april 2016,Annas Väg 10,"Kärna,",62,4,66,4,1 317,2600000
Såld 8 april 2016,Gunneröd 320,"Lycke,",145,5,150,5,1 144,3150000
Såld 6 april 2016,Gårdskiftegatan 64,"Ytterby,",139,31,170,7,803,3200000
Såld 4 april 2016,Lahälla 610,"Skåra,",160,82,242,6,2 098,5450000
Såld 29 mars 2016,Plogvägen 203,"Kungälv,",122,9,131,5,295,4480000
Såld 24 mars 2016,Gamla Torget 10,"Centrum,",113,4,117,4,134,3970000
Såld 24 mars 2016,Solskiftegatan 9,"Kungälv,",140,58,198,6,958,3850000
Såld 23 mars 2016,Högsberg 325,"Kode,",100,4,104,4,1 662,3250000
Såld 22 mars 2016,Matskärsvägen 37,"Tjuvkil,",83,48,131,5,1 430,3530000
Såld 21 mars 2016,Flateby 490,"Harestad,",165,67,232,7,1 030,1995000
Såld 18 mars 2016,Knaverstad-Ryr 590,"Aröd,",90,3,93,3,1 007,2500000
Såld 17 mars 2016,Plogvägen 193,"Ullstorp,",106,4,110,4,407,3925000
Såld 16 mars 2016,Näckrosvägen 7,"Kärna,",148,75,223,6,1 553,4220000
Såld 11 mars 2016,Sköldgatan 3,"Ytterby - Stället,",136,4,140,4,443,4150000
Såld 9 mars 2016,Duvesjön 368,"Romelanda,",117,35,152,5,1 132,3225000
Såld 8 mars 2016,Stora Ryr 340,"Kärna,",144,12,156,5,952,2900000
Såld 4 mars 2016,Björkliden 18,"Aröd,",60,60,120,3,1 050,2470000
Såld 2 mars 2016,Kärnavägen 27,"Kärna,",150,30,180,6,862,3730000
Såld 29 februari 2016,Dotorp 470,"Kärna,",70,0,70,,19 948,1580000
Såld 24 februari 2016,Marias Väg 18,"Aröd,",73,3,76,3,1 498,2000000
Såld 24 februari 2016,Stenhålt 125,"Romelanda,",157,38,195,6,5 000,3275000
Såld 24 februari 2016,Hasselvägen 7,"Romelanda,",134,48,182,7,977,3410000
Såld 23 februari 2016,Skårsäng 2,"Kärna,",114,5,119,5,977,3195000
Såld 20 februari 2016,Tegskiftegatan 46,"Tega,",114,117,231,8,865,4100000
Såld 19 februari 2016,Skårby Mosse 895,"Kareby,",156,5,161,5,1 583,3500000
Såld 17 februari 2016,Duvesjön 317,"Romelanda,",103,5,108,5,1 084,3150000
Såld 15 februari 2016,Staby 340,"Kärna,",159,125,284,6,1 207,4500000
Såld 11 februari 2016,Tulpanvägen 4,"Kärna,",118,70,188,6,783,3500000
Såld 10 februari 2016,Östergårdsgatan 31,"Ytterby,",154,54,208,6,809,3880000
Såld 9 februari 2016,Oskarsbergsgatan 20,"Ytterby,",120,68,188,6,929,4020000
Såld 29 januari 2016,Byvägen 20,"Kode,",64,25,89,4,1 642,2600000
Såld 26 januari 2016,Reidarsgatan 5,"Komarken,",119,57,176,6,686,2650000
Såld 24 januari 2016,Slånbärsvägen 9,"Kungälv - Centralt,",140,4,144,4,855,5350000
Såld 22 januari 2016,Ulvesund 438,"Kungälv - Ytterby,",90,5,95,5,760,3150000
Såld 19 januari 2016,Bredsten 416,"Ytterby,",158,14,172,6,26 920,6800000
Såld 18 januari 2016,Skårby Station 520,"Kareby,",117,55,172,5,1 060,2995000
Såld 18 januari 2016,Vena 170,"Vena - Ytterby,",183,1,184,6,2 650,3700000
Såld 16 januari 2016,Granndalen 2,"Lycke,",114,4,118,4,1 619,2175000
Såld 13 januari 2016,Hanekullen 205,"Kareby,",90,90,180,2,1 885,3900000
Såld 13 januari 2016,Smaragdvägen 30,"Kode,",131,14,145,5,362,3430000
Såld 12 januari 2016,Hallbjörtorp 500,"Kärna,",162,6,168,6,2 752,4070000
Såld 10 januari 2016,Mantalsgatan 26,"Tega - Ytterby,",153,54,207,7,1 922,4570000
Såld 5 januari 2016,Skepparegatan 5,"Marstrand - Koön,",184,25,209,9,474,8000000
Såld 22 december 2015,Spadvägen 1,"Ullstorp,",75,40,115,3,1 236,2970000
Såld 8 december 2015,Timmervik 140,"Bohuslän,",180,45,225,7,1 119,3695000
Såld 6 december 2015,Häljeröd 490,"Bohuslän,",205,100,305,9,4 355,4975000
Såld 2 december 2015,Näckrosvägen 7,"Kungälv,",,,0,,1 300,1200000
Såld 26 november 2015,Duvesjön 374,"Duvesjön,",110,4,114,4,1 000,3150000
Såld 26 november 2015,Blåsippegatan 3,"Ytterby,",182,6,188,6,579,4600000
Såld 23 november 2015,Heavägen 13,"Lycke,",121,4,125,4,970,3300000
Såld 17 november 2015,Mossvägen 13,"Kungälv Lökeberg,",96,10,106,4,1 376,2600000
Såld 17 november 2015,Skårby Station 452,"Kareby,",122,2,124,2,2 963,3500000
Såld 9 november 2015,Bergliden 20,"Aröd,",65,36,101,3,1 322,2210000
Såld 8 november 2015,Plogvägen 184,"Kungälv Ullstorp,",122,5,127,5,363,4410000
Såld 3 november 2015,Hällristningsgatan 8,"Ytterby,",103,0,103,,262,3500000
Såld 2 november 2015,Jörlandavägen 3,"Kode,",115,48,163,5,1 165,2325000
Såld 2 november 2015,Häljeröd 320,"Romelanda,",144,24,168,5,5 814,3950000
Såld 30 oktober 2015,Rådmansgatan 13,"Centrum,",92,92,184,5,636,4900000
Såld 30 oktober 2015,Lundby 180,"Kareby,",200,63,263,7,1 518,3400000
Såld 30 oktober 2015,Vedhallsvägen 8,"Kärna,",116,72,188,6,1 864,2250000
Såld 23 oktober 2015,Guddeby 250,"Ytterby,",174,8,182,8,1 733,4000000
Såld 23 oktober 2015,Kareby Kyrkväg 340,"Kareby,",183,5,188,5,1 010,2950000
Såld 22 oktober 2015,Stora Ryr 280,"Bohuslän,",96,15,111,3,2 254,1950000
Såld 20 oktober 2015,Fontinvägen 22,"Kungälv - Centrum,",130,140,270,8,1 034,5900000
Såld 19 oktober 2015,Gamla Trollhättevägen 22,"Kungälv,",65,60,125,2,1 246,2000000
Såld 18 oktober 2015,Settungsvägen 36,"Kungälv Ullstorp,",140,20,160,6,362,4800000
Såld 16 oktober 2015,Bergåsvägen 21,"Ytterby Tunge,",130,70,200,6,972,3570000
Såld 14 oktober 2015,Kämpegatan 5,"Kungälv Centralt,",107,105,212,6,842,3850000
Såld 14 oktober 2015,Häljeröd 330,"Kungälv,",145,5,150,6,6 686,4055500
Såld 14 oktober 2015,Mjölnarvägen 14,"Romelanda,",124,85,209,5,820,3200000
Såld 13 oktober 2015,Hjälmgatan 9,"Ytterby,",96,6,102,3,467,3225000
Såld 12 oktober 2015,Rävo 130,"Hålta,",114,114,228,5,5 500,4350000
Såld 8 oktober 2015,Veneröd 540,"Hålta,",250,7,257,7,1 982,4065000
Såld 8 oktober 2015,Ulvesund 110,"Ytterby,",153,50,203,4,3 024,3200000
Såld 7 oktober 2015,Helgonagatan 50,"Munkegärde,",117,4,121,4,1 675,2416667
Såld 7 oktober 2015,Bärnstensvägen 11,"Kode,",98,75,173,6,1 005,3195000
Såld 28 september 2015,Rosenstensvägen 11,"Kode,",140,15,155,5,562,3350000
Såld 26 september 2015,Gårdskiftegatan 13,"Ytterby - Tega,",140,5,145,5,1 034,3995000
Såld 26 september 2015,Storskiftegatan 96,"Ytterby Tega Kungälv,",140,5,145,5,810,4050000
Såld 24 september 2015,Ingetorp 130,"Kode,",120,60,180,5,1 874,3050000
Såld 22 september 2015,Solvagnsgatan 42,"Ytterby - Stället,",138,12,150,5,401,4325000
Såld 21 september 2015,Settungsvägen 42,"Ullstorp,",149,7,156,7,620,4900000
Såld 17 september 2015,Häljeröd 250,"Romelanda,",108,6,114,6,7 088,2995000
Såld 17 september 2015,Tofta 330,"Tofta,",110,5,115,5,2 927,6700000
Såld 16 september 2015,Stämmdalen 120,"Lycke,",96,66,162,5,1 104,1895000
Såld 13 september 2015,Lökebergsvägen 27,"Kungälv Lökeberg,",120,45,165,5,1 198,3840000
Såld 11 september 2015,Brunnefjäll 180,"Kärna Vedhall,",143,60,203,5,1 887,3470000
Såld 10 september 2015,Häljeröd 270,"Romelanda - Diseröd,",111,88,199,6,3 100,2495000
Såld 10 september 2015,Buderöd 160,"Kode,",118,84,202,5,22 600,4075000
Såld 9 september 2015,Tegskiftegatan 48,"Ytterby Tega Kungälv,",157,102,259,9,1 083,4950000
Såld 3 september 2015,Broberg 130,"Bohuslän,",130,37,167,6,2 400,3425000
Såld 2 september 2015,Sköldgatan 4,"Ytterby,",95,8,103,3,399,3075000
Såld 31 augusti 2015,Korpedalsvägen 10,"Aröd,","73,5",3,,3,1 099,1850000
Såld 31 augusti 2015,Käckås 110,"Ytterby,",98,87,185,5,11 226,4400000
Såld 28 augusti 2015,Diserödsvägen 7,"Kungälv Romelanda Diseröd,",127,52,179,5,737,2830000
Såld 26 augusti 2015,Västra Strandgatan 17,"Kungälv - Centrum,",130,80,210,5,690,3575000
Såld 13 augusti 2015,Lövön 410,"Lövön - Kungälv/Marstrand,",93,3,96,3,2 467,3050000
Såld 30 juli 2015,Toftebergsvägen 2,"Tjuvkil,",82,6,88,4,1 085,1550000
Såld 24 juli 2015,Truskärsvägen 7,"Tjuvkil,",181,83,264,6,3 390,4350000
Såld 10 juli 2015,Lundby 450,"Kungälv - Kareby,",125,142,267,5,2 522,3525000
Såld 9 juli 2015,Solskiftegatan 63,"Övre Tega - Ytterby,",171,31,202,6,810,4300000
Såld 3 juli 2015,Korsgatan 4 a och b,"Marstrand Koön,",,,0,,393,11000000
Såld 1 juli 2015,Flateby 180,"Harestad,",119,98,217,6,5 476,3400000
Såld 30 juni 2015,Bräcke 330,"Kärna,",85,4,89,4,1 188,1700000
Såld 29 juni 2015,Oskarsbergsgatan 10,"Ytterby - Tega, Kungälv,",157,5,162,5,784,3200000
Såld 27 juni 2015,Safirvägen 1,"Kode,",131,5,136,5,753,2700000
Såld 26 juni 2015,Strömgatan 6,"Ytterby,",98,71,169,5,1 169,3100000
Såld 24 juni 2015,Bollestad 140,"Kareby,",110,5,115,6,19 720,3200000
Såld 23 juni 2015,Domsvägen 8,"Ytterby Tunge,",160,5,165,5,1 184,3200000
Såld 17 juni 2015,Stora Risby 380,"Kungälv - Hålta,",75,55,130,5,963,2200000
Såld 16 juni 2015,Solvagnsgatan 16,"Ytterby - Stället,",165,12,177,6,771,5275000
Såld 16 juni 2015,Kyrkeby 340,"Kärna - Harestad,",188,7,195,7,5 010,3700000
Såld 14 juni 2015,Lievägen 242,"Kungälv - Ullstorp,",122,5,127,5,236,3970000
Såld 14 juni 2015,Kungälvsvägen 22,"Kungälv Gamla Grinden,",112,"4,5",,"4,5",1 548,3250000
Såld 13 juni 2015,Årsnäs 460,"Solberga - Kode,",40,3,43,3,2 393,2300000
Såld 12 juni 2015,Dammkärrsvägen 1,"Lycke,",84,3,87,3,1 078,2700000
Såld 10 juni 2015,Hammarhöjden 690,"Kode,",76,3,79,3,1 141,1600000
Såld 5 juni 2015,Slottsgatan 6,"Marstrand - Koön,",126,14,140,6,340,8000000
Såld 4 juni 2015,Högsberg 360,"Kode,",72,65,137,3,2 242,2500000
Såld 4 juni 2015,Lefstad 190,"Bohuslän,",65,68,133,3,1 906,1975000
Såld 3 juni 2015,Bredsten 118,"Ytterby,",147,6,153,6,1 570,4725000
Såld 3 juni 2015,Hanekullen 210,"Kungälv - Kareby,",148,30,178,5,1 892,4150000
Såld 31 maj 2015,Länsmansvägen 2,"Ytterby,",195,195,390,7,1 753,4200000
Såld 29 maj 2015,Marieberg 220,"Romelanda,",183,12,195,5,1 541,3500000
Såld 29 maj 2015,Sörgårdsvägen 510,"Kungälv Kärna Sundhammar,",200,45,245,9,1 930,3660000
Såld 29 maj 2015,Sörgårdsvägen 530,"Kungälv Kärna Sundhammar,",139,5,144,5,1 337,3350000
Såld 29 maj 2015,Husfrejagatan 4,"Kungälv Iskällan,",127,174,301,7,938,3675000
Såld 28 maj 2015,Bredsten 330,"Bredsten,",180,6,186,6,3 224,2650000
Såld 27 maj 2015,Korpvägen 277,"Kungälv - Ullstorp,",134,5,139,5,518,4730000
Såld 23 maj 2015,Kvarnvägen 22,"Kungälv - Ingetorp,",68,68,136,5,1 318,2800000
Såld 22 maj 2015,Korpvägen 265,"Kungälv,",133,26,159,5,401,4750000
Såld 20 maj 2015,Bagaregatan 15,"Kungälv centralt,",191,6,197,6,735,4525000
Såld 19 maj 2015,Västerhöjdsvägen 14,"Kärna,",121,"20,2",,5,369,950000
Såld 19 maj 2015,Madängsgatan 13,"Centralt Kungälv,",154,15,169,7,740,3995000
Såld 18 maj 2015,Gråstensvägen 37,"Kode,","107,5","40,5",,4,1 374,3420000
Såld 18 maj 2015,Klövergången 15,"Kungälv Centralt,",125,4,129,4,401,3350000
Såld 13 maj 2015,Hammarberg 885,"Kode,",67,3,70,3,1 195,1850000
Såld 8 maj 2015,Kållen 130,"Romelanda,",111,53,164,5,3 756,2775000
Såld 6 maj 2015,Vämneröd 120,"Kode,",54,3,57,3,2 283,1595000
Såld 1 maj 2015,Duvesjön 344,"Bohuslän,",120,50,170,4,1 136,3325000
Såld 30 april 2015,Otterlyckevägen 13,"Marstrand - Instön,",115,4,119,4,975,3300000
Såld 30 april 2015,Kyrkogatan 15,"Marstrandsön,",115,25,140,6,367,10000000
Såld 29 april 2015,Björröd 310,"Kode,",172,6,178,6,1 514,3510000
Såld 29 april 2015,Hallsbergsvägen 14,"Kode,",100,4,104,4,576,2880000
Såld 27 april 2015,Södra Ekelöv 155,"Hålta,",140,66,206,6,2 761,3395000
Såld 23 april 2015,Kungälvsvägen 73,"Grinden,",93,51,144,5,1 469,3525000
Såld 18 april 2015,Vämneröd 140,"Kode,",133,4,137,4,2 639,4100000
Såld 16 april 2015,Stenåldersgatan 36,"Ytterby - Stället,",122,4,126,4,349,3950000
Såld 16 april 2015,Västra Röd 340,"Kärna - Harestad,",117,66,183,6,1 472,2150000
Såld 16 april 2015,Byvägen 59,"Ödsmålsmosse,",104,20,124,4,1 791,2900000
Såld 16 april 2015,Enskiftegatan 17,"Ytterby Tega,",145,5,150,5,990,3700000
Såld 9 april 2015,Kristinedalsgatan 15,"Centralt,",145,80,225,6,1 191,4300000
Såld 31 mars 2015,Sköldgatan 6,"Ytterby - Stället,",96,8,104,3,402,3020000
Såld 30 mars 2015,Almvägen 19,"Romelanda Torp,",140,5,145,5,801,3110000
Såld 27 mars 2015,Solvagnsgatan 10,"Stället,",139,12,151,5,405,4140000
Såld 26 mars 2015,Stora Ryr 135,"Lycke,",194,8,202,8,1 551,3750000
Såld 25 mars 2015,Tröskvägen 272,"Ullstorp,",148,10,158,7,678,4870000
Såld 25 mars 2015,Apelvägen 13,"Romelanda,",106,4,110,6,449,2850000
Såld 24 mars 2015,Prästvägen 715,"Romelanda,",122,122,244,4,1 025,3400000
Såld 24 mars 2015,Kovikshamn 200,"Kungälv - Kovikshamn,",90,85,175,3,1 361,3500000
Såld 24 mars 2015,Kulperödsvägen 11B,"Kungälv - Hålta,",120,127,247,6,1 007,5100000
Såld 23 mars 2015,Hallebäcksvägen 2,"Kode,",73,7,80,4,1 029,1500000
Såld 20 mars 2015,Flateby 590,"Harestad,",114,65,179,3,3 853,1995000
Såld 20 mars 2015,Fågelstigen 36,"Kungälv,",113,5,118,4,177,2980000
Såld 19 mars 2015,Skutviksvägen 6,"Marstrand - Instön,",90,3,93,3,1 506,3350000
Såld 19 mars 2015,Munkegärdegatan 320,"Munkegärde,",148,36,184,7,675,4400000
Såld 19 mars 2015,Ödsmål 595,"Rörtången,",78,3,81,3,12 760,5000000
Såld 18 mars 2015,Norrmannebo 740 A,"Norrmannebo,",84,9,93,5,931,1350000
Såld 18 mars 2015,Akvamarinvägen 9,"Kode,",107,5,112,5,745,2700000
Såld 14 mars 2015,Vävra 760,"Hålta,",174,7,181,7,1 792,5800000
Såld 11 mars 2015,Norrmannebo 800,"Norrmannebo,",150,10,160,6,2 964,2600000
Såld 6 mars 2015,Onyxvägen 4,"Kode,",155,6,161,6,669,3600000
Såld 5 mars 2015,Kulperödsvägen 17,"Bohuslän,",133,119,252,6,2 141,4200000
Såld 5 mars 2015,Rishammarvägen 33,"Kungälv,",112,4,116,4,1 003,3430000
Såld 3 mars 2015,Duvesjön 346,"Kungälv - Romelanda,",145,7,152,6,900,3250000
Såld 27 februari 2015,Tvetgatan 49,"Bohuslän,",110,0,110,,156,2100000
Såld 27 februari 2015,Vitsippegatan 8,"Ytterby,",181,7,188,7,579,3595000
Såld 26 februari 2015,Hemvägen 41,"Kungälv - Romelanda,",141,7,148,7,924,3610000
Såld 26 februari 2015,Fregattgatan 5,"Centralt,",126,65,191,5,506,4300000
Såld 26 februari 2015,Munkholmsgatan 7,"Kungälv,",95,4,99,4,796,2750000
Såld 26 februari 2015,Lilla Ryr 200,"Kungälv - Lycke,",60,60,120,2,1 406,2400000
Såld 21 februari 2015,Stenåldersgatan 6,"Ytterby Stället,",104,4,108,4,318,3200000
Såld 13 februari 2015,Gullbringa 110,"Hålta,",180,5,185,5,2 068,3495000
Såld 13 februari 2015,Bärnstensvägen 1,"Kode,",177,170,347,7,1 070,3050000
Såld 12 februari 2015,Tvetgatan 123,"Kungälv,",109,5,114,5,300,2450000
Såld 12 februari 2015,Mellan-Restad 270,"Hålta,",160,14,174,5,1 233,3315000
Såld 11 februari 2015,Alekärr 125,"Romelanda,",120,3,123,3,1 950,3400000
Såld 10 februari 2015,Hällristningsgatan 12,"Kungälv Ytterby,",107,5,112,5,560,3425000
Såld 3 februari 2015,Tegskiftegatan 28,"Kungälv - Ytterby,",134,134,268,7,832,4700000
Såld 28 januari 2015,Grandalen 190,"Kungälv-Svartedalen,",105,60,165,3,1 378,1900000
Såld 21 januari 2015,Stenhålt 352,"Kungälv - Romelanda,",151,6,157,6,1 630,3810000
Såld 18 januari 2015,Vävra 120,"Bohuslän,",121,25,146,7,3 352,2600000
Såld 16 januari 2015,Trankärrsliden 21,"Tveten & Skälebräcke,",110,75,185,5,1 216,2950000
Såld 16 januari 2015,Rubinvägen 19,"Kode,",195,6,201,6,937,3400000
Såld 14 januari 2015,Åsebyberg 853,"Kode,",137,5,142,5,1 462,3395000
Såld 13 januari 2015,Lundby 475,"Kareby,",141,40,181,5,2 024,4000000
Såld 11 januari 2015,Bergkristallvägen 20,"Kode,",127,5,132,5,572,3760000
Såld 2 januari 2015,Rosenstensvägen 43,"Bohuslän,",135,0,135,,188,2600000
Såld 20 december 2014,Åsebyberg 685,"Kode,",115,3,118,3,1 374,2995000
Såld 12 december 2014,Gårdskiftegatan 17,"Tega,",163,35,198,6,1 147,4050000
Såld 4 december 2014,Tröskvägen 260,"Ullstorp,",140,6,146,6,410,4450000
Såld 3 december 2014,Skälebräckeliden 8,"Kungälv - Centrum,",125,85,210,8,1 055,4250000
Såld 28 november 2014,Ängsgatan 19,"Centralt,",145,62,207,9,626,3160000
Såld 21 november 2014,Kullegatan 10,"Centralt,",113,51,164,7,543,3275000
Såld 20 november 2014,Tomt centrala Ytterby,"Ytterby,",156,7,163,7,600,1150000
Såld 20 november 2014,Nolby 170,"Kode,",203,55,258,6,7 383,4100000
Såld 17 november 2014,Duvesjön 335,"Duvesjön,",121,5,126,5,1 205,2750000
Såld 17 november 2014,Kulperödsvägen 10,"Kungälv - Hålta,",175,14,189,6,2 341,3850000
Såld 16 november 2014,Häljeröd 300,"Kungälv - Romelanda,",223,25,248,7,5 647,5000000
Såld 16 november 2014,Stenåldersgatan 52,"Ytterby,",117,4,121,4,345,3400000
Såld 14 november 2014,Rondan 8,"Ödsmålsmosse,",125,29,154,5,1 106,2920000
Såld 12 november 2014,Älvliden 2,"Kungälv,",118,50,168,5,405,3450000
Såld 12 november 2014,Östergårdsgatan 23,"Ytterby,",180,48,228,6,840,3500000
Såld 9 november 2014,Duvesjön 217,"Duvesjön / Kungälv,",120,36,156,4,1 091,3030000
Såld 31 oktober 2014,Dotorp 230,"Kärna,",64,42,106,3,986,1800000
Såld 28 oktober 2014,Munkegärdegatan 251,"Kungälv,",178,109,287,8,849,4325000
Såld 28 oktober 2014,Duvesjön 232,"Duvesjön,",122,5,127,5,1 076,2780000
Såld 23 oktober 2014,Onyxvägen 23,"Kungälv, Kode,",155,7,162,7,514,2940000
Såld 20 oktober 2014,Västra Röd 180,"Kungälv - Harestad,",150,5,155,5,514,5200000
Såld 15 oktober 2014,Snäckvägen 3,"Ödsmålsmosse,",76,28,104,4,1 213,2575000
Såld 13 oktober 2014,Tulpanvägen 1,"Kärna,",127,105,232,7,568,2225000
Såld 9 oktober 2014,Tegskiftegatan 50,"Tega,",112,57,169,5,856,3150000
Såld 7 oktober 2014,Gråstensvägen 26,"Kode,",191,6,197,6,1 149,3720000
Såld 2 oktober 2014,Matskärsvägen 104,"Tjuvkil (norra delen)+Baracken,",134,5,139,5,996,4520000
Såld 26 september 2014,Idrottsgatan 26,"Marstrand, Koön,",130,20,150,5,565,4075000
Såld 25 september 2014,Åseby 350,"Kode,",169,8,177,8,1 113,4850000
Såld 25 september 2014,Västra Röd 130,"Kärna - Harestad,",136,15,151,4,1 170,3100000
Såld 25 september 2014,Skår 170,"Kärna,",90,101,191,6,1 054,2500000
Såld 15 september 2014,Önneröd 140,"Kärna,",110,110,220,,2 439,2050000
Såld 10 september 2014,Hjälmgatan 1,"Ytterby - Stället,",96,8,104,3,444,2900000
Såld 9 september 2014,Prejelvägen 114,"Ullstorp,",122,5,127,5,366,3750000
Såld 9 september 2014,Långåkersgatan 11,"Kungälv Centralt,",129,36,165,5,1 136,4700000
Såld 8 september 2014,Gamla Torget 10,"Kungälv Gamla Staden,",90,23,113,4,134,3200000
Såld 8 september 2014,Stenåldersgatan 18,"Ytterby - Stället,",103,4,107,4,297,3366500
Såld 2 september 2014,Norrmannebo 680,"Romelanda,",172,71,243,7,4 202,1700000
Såld 31 augusti 2014,Vråkärrsvägen 8,"Kungälv,",48,3,51,3,847,1400000
Såld 28 augusti 2014,Annas Väg 14,"Kovikshamn,",90,4,94,4,1 515,2450000
Såld 26 augusti 2014,Västerhöjdsvägen 18,"Kärna,",115,3,118,4,291,3100000
Såld 22 augusti 2014,Gategården 182,"Hålta,",240,50,290,8,1 484,2975000
Såld 22 augusti 2014,Stenhålt 130,"Romelanda,",180,5,185,5,3 824,3600000
Såld 20 augusti 2014,Västra Porten 28,"Ytterby,",120,16,136,3,954,3485000
Såld 13 augusti 2014,Rondan 22,"Ödsmålsmosse,",72,65,137,6,1 258,1900000
Såld 8 augusti 2014,Duvesjön 338,"Kungälv - Romelanda,",115,4,119,4,1 063,2795000
Såld 2 juli 2014,Åsebyberg 725,"Åseby,",156,5,161,5,1 101,3525000
Såld 30 juni 2014,Hasselvägen 4,"Romelanda - Diseröd,",125,125,250,9,805,2300000
Såld 25 juni 2014,Vävra 542,"Hålta,",109,15,124,5,1 106,2750000
Såld 19 juni 2014,Halleravägen 8B,"Kovikshamn,",150,30,180,7,3 419,6050000
Såld 19 juni 2014,Björkebacka 118,"Kareby,",145,5,150,5,2 372,3200000
Såld 18 juni 2014,Häljeröd 190,"Romelanda,",84,79,163,5,7 965,2710000
Såld 18 juni 2014,Hålta Annex 150,"Hålta,",32,2,34,2,1 208,1000000
Såld 17 juni 2014,Granndalen 14,"Lycke,",62,4,66,4,1 229,2250000
Såld 16 juni 2014,Vävra 540,"Bohuslän,",53,3,56,3,1 863,2210000
Såld 15 juni 2014,Krokens Väg 18,"Tjuvkil,",70,4,74,4,1 530,2650000
Såld 11 juni 2014,Kristinedalsgatan 6,"Centralt,",177,67,244,6,802,4250000
Såld 31 maj 2014,Illekärr 170,"Kungälv - Romelanda,",152,80,232,6,6 070,2720000
Såld 27 maj 2014,Lagvägen 53,"Kungälv - Ytterby,",157,51,208,6,779,2950000
Såld 27 maj 2014,Snäckvägen 9,"Ödsmålsmosse,",76,3,79,3,1 562,2100000
Såld 22 maj 2014,Matskärsvägen 102,"Tjuvkil,",71,3,74,3,1 433,4550000
Såld 22 maj 2014,Skårby Station 150,"Kareby,",97,50,147,4,3 446,2020000
Såld 20 maj 2014,Solberga 510,"Solberga - Kode,",98,58,156,5,1 517,2215000
Såld 17 maj 2014,Löstorp 130,"Kareby,",171,7,178,6,4 580,4200000
Såld 14 maj 2014,Torsby 130,"Kärna,",95,4,99,4,2 538,2360000
Såld 10 maj 2014,Åsleröd 110,"Ytterby,",57,57,114,3,975,1470000
Såld 8 maj 2014,Tingsvägen 3,"Ytterby,",143,6,149,6,723,2570000
Såld 2 maj 2014,Bremnäs 390,"Lycke, Kärna,",98,3,101,3,2 770,2850000
Såld 30 april 2014,Ulvesund 412,"Ytterby-Ulvesund,",106,4,110,4,806,2800000
Såld 29 april 2014,Lundby 340,"Kareby,",147,6,153,6,1 648,3200000
Såld 29 april 2014,Rådalsvägen 7,"Aröd,",60,31,91,5,1 500,2500000
Såld 26 april 2014,Västerhöjdsvägen 26,"Kärna,",103,5,108,5,250,2900000
Såld 22 april 2014,Parken 110,"Solberga Kode,",157,100,257,5,4 160,3950000
Såld 18 april 2014,Västra Brattön,"Brattön,",70,4,74,4,1 377,4900000
Såld 16 april 2014,Kämpegatan 7,"Centralt,",121,103,224,6,899,3125000
Såld 15 april 2014,Skäggstorp 160,"Kode,",28,2,30,2,1 257,600000
Såld 12 april 2014,Grokareby 110,"Kareby,",120,80,200,4,2 367,2400000
Såld 6 april 2014,Fågelstigen 44,"Kungälv,",128,5,133,5,377,3275000
Såld 26 mars 2014,Heden 190,"Kärna - Harestad,",74,45,119,4,2 064,2482000
Såld 26 mars 2014,Mantalsgatan 9,"Ytterby,",175,35,210,8,1 105,3850000
Såld 25 mars 2014,Granndalen 5,"Lycke,",91,4,95,4,1 330,2095000
Såld 21 mars 2014,Lundby 390,"Kareby,",180,115,295,,5 123,2595000
Såld 20 mars 2014,Vältvägen 509,"Ullstorp,",105,10,115,4,319,3160000
Såld 18 mars 2014,Matskärsvägen 98b,"Tjuvkil,",90,4,94,4,1 012,3825000
Såld 13 mars 2014,Topasvägen 11,"Kode,",103,95,198,6,742,2375000
Såld 12 mars 2014,Gunneröd 170,"Lycke,",98,3,101,3,2 301,2350000
Såld 11 mars 2014,Häljeröd 550,"Kode,",135,35,170,4,3 880,2530000
Såld 10 mars 2014,Duvesjön 312,"Duvesjön,",119,5,124,5,1 652,3100000
Såld 7 mars 2014,Lagvägen 31,"Ytterby,",89,76,165,4,1 330,2175000
Såld 5 mars 2014,Helgonagatan 192,"Munkegärde,",93,21,114,5,191,2900000
Såld 4 mars 2014,Högalidsgatan 5,"Centralt,",109,109,218,4,805,2820000
Såld 27 februari 2014,Solhultsgatan 17,"Centralt,",189,15,204,8,481,2900000
Såld 20 februari 2014,Gunneröd 270,"Lycke,",57,45,102,4,2 646,1850000
Såld 13 februari 2014,Lönnvägen 3,"Enekullen,",148,6,154,6,635,3100000
Såld 8 februari 2014,Ulvesund 410,"Ytterby-Ulvesund,",77,25,102,5,795,2230000
Såld 3 februari 2014,Ulvebackegatan 12,"Ulvegärde,",140,38,178,5,914,3625000
Såld 21 januari 2014,Gårdskiftegatan 16,"Ytterby,",114,5,119,5,139,2083000
Såld 21 januari 2014,Fridhemsgatan 9,"Centralt,",137,90,227,6,850,3525000
Såld 17 januari 2014,Bärnstensvägen 6,"Kode,",93,92,185,4,1 009,2275000
Såld 15 januari 2014,Prejelvägen 110,"Ullstorp,",122,5,127,5,320,3230000
Såld 23 december 2013,Ulvesund 464,"Ytterby-Ulvesund,",63,2,65,2,743,1750000
Såld 16 december 2013,Hällristningsgatan 15,"Stället,",107,5,112,5,430,3300000
Såld 12 december 2013,Väktaregatan 5,"Centralt,",142,70,212,6,566,4850000
Såld 6 december 2013,Solskiftegatan 9,"Tega,",140,58,198,6,958,2850000
Såld 29 november 2013,Rishammar 260,"Bohuslän,",154,86,240,7,2 982,2525000
Såld 29 november 2013,Skurhagagatan 4,"Centralt,",190,75,265,7,798,2750000
Såld 27 november 2013,Domsvägen 4,"Ytterby,",98,77,175,5,858,2150000
Såld 25 november 2013,Åldermansvägen 9,"Ytterby,",174,74,248,5,1 119,3600000
Såld 15 november 2013,Västerhöjdsvägen 24,"Kärna,",150,5,155,5,596,4160000
Såld 15 november 2013,Thorilds Gränd 9,"Centralt,",121,3,124,4,422,4610000
Såld 13 november 2013,Åldermansvägen 12,"Ytterby,",124,124,248,5,909,3745000
Såld 12 november 2013,Lundby 380,"Kareby,",140,4,144,4,1 818,2900000
Såld 11 november 2013,Oskarsbergsgatan 34,"Tega,",119,48,167,4,773,3020000
Såld 4 november 2013,Fontinvägen 26,"Centralt,",166,63,229,6,1 083,4675000
Såld 31 oktober 2013,Jägarvägen 6,"Bohuslän,",159,16,175,5,564,2200000
Såld 25 oktober 2013,Komministergatan 16,"Centralt,",175,100,275,7,723,5100000
Såld 22 oktober 2013,Fredkullagatan 24,"Centralt,",80,40,120,4,918,2440000
Såld 18 oktober 2013,Ulvesund 305,"Ytterby-Ulvesund,",154,7,161,7,775,2690000
Såld 18 oktober 2013,Vävra 535,"Vävra,",60,3,63,3,1 069,1460000
Såld 11 oktober 2013,Åsleröd 110,"Ytterby,",57,57,114,3,975,1555000
Såld 11 oktober 2013,Rundsvallen 150,"Ytterby - Rundsvallen,",142,15,157,5,1 440,2850000
Såld 11 oktober 2013,Krappvägen 574,"Ullstorp,",170,29,199,5,807,4845000
Såld 9 oktober 2013,Staby 774,"Kärna,",121,4,125,4,1 127,2740000
Såld 8 oktober 2013,Glose 590,"Glose,",108,57,165,5,1 799,1850000
Såld 8 oktober 2013,Svärdgatan 6,"Stället,",137,8,145,5,392,3560000
Såld 3 oktober 2013,Drakegatan 8,"Centralt,",121,39,160,4,853,3400000
Såld 18 september 2013,Hällevad 140,"Duvesjön,",144,58,202,6,2 077,2955000
Såld 13 september 2013,Holm 230,"Kärna,",155,7,162,6,2 861,3700000
Såld 9 september 2013,Braseröd 120,"Romelanda,",108,8,116,4,7 164,1895000
Såld 30 augusti 2013,Lahälla 760,"Lahälla,",181,60,241,5,2 559,4500000
Såld 30 augusti 2013,Olsegården 13,"Olseröd,",140,32,172,5,375,3280000
Såld 28 augusti 2013,Heden 180,"Ytterby-Ulvesund,",60,57,117,3,2 279,2500000
Såld 28 augusti 2013,Brunnefjäll 132,"Kärna - Vedhall,",220,6,226,6,1 076,4490000
Såld 27 augusti 2013,Kållstorp 140,"Kärna - Harestad,",110,5,115,5,3 436,1360000
Såld 26 augusti 2013,Rönnvägen 14,"Romelanda - Diseröd,",109,109,218,6,1 059,2710000
Såld 20 augusti 2013,Ängsgatan 13,"Centralt,",111,92,203,4,564,2550000
Såld 15 augusti 2013,Strandgatan 10B,"Centralt,",101,"6,5",,4,414,3230000
Såld 15 augusti 2013,Marielundsvägen 16,"Marstrand - Koön,",163,5,168,5,702,4500000
Såld 15 augusti 2013,Kuskalundsvägen 12,"Vävra,",87,4,91,4,1 379,1835000
Såld 13 augusti 2013,Vävra 705,"Hålta,",118,11,129,4,1 206,2450000
Såld 5 augusti 2013,Rönnvägen 1,"Romelanda - Diseröd,",98,71,169,5,941,2250000
Såld 22 juli 2013,Slånvägen 5,"Kärna,",207,209,416,9,2 017,3550000
Såld 18 juli 2013,Dalen 240,"Kärna,",85,3,88,3,2 611,1750000
Såld 9 juli 2013,Duvesjön 210,"Duvesjön,",133,5,138,5,1 768,2750000
Såld 3 juli 2013,Duvesjön 234,"Bohuslän,",119,4,123,4,1 147,3000000
Såld 25 juni 2013,Åsebyberg 680,"Åsebyberg,",51,2,53,2,1 206,1550000
Såld 18 juni 2013,Ulvesund 408,"Ytterby-Ulvesund,",52,3,55,3,805,1600000
Såld 13 juni 2013,Karantänsgatan 4,"Bohuslän,",145,70,215,7,619,4000000
Såld 12 juni 2013,Skogsvägen 20,"Ingetorp,",101,4,105,4,1 318,1785000
Såld 9 juni 2013,Rörtången 123,"Rörtången,",101,70,171,3,1 010,3600000
Såld 31 maj 2013,Toreby 280,"Kärna - Harestad,",146,6,152,6,2 013,2770000
Såld 30 maj 2013,Kållstorp 140,"Kärna - Harestad,",110,5,115,5,3 436,1700000
Såld 29 maj 2013,Lievägen 224,"Ullstorp,",122,5,127,5,304,3470000
Såld 29 maj 2013,Beryllvägen 14,"Kode,",145,5,150,5,434,3020000
Såld 24 maj 2013,Gårdskiftegatan 41,"Ytterby-Tega,",174,14,188,6,735,3075000
Såld 24 maj 2013,Kuskalundsvägen 36,"Vävra,",120,45,165,6,1 339,1850000
Såld 23 maj 2013,Vävra 170,"Hålta,",62,4,66,4,1 860,1385000
Såld 23 maj 2013,Stinneröd 160,"Romelanda,",37,2,39,2,1 815,595000
Såld 16 maj 2013,Grokareby 150,"Kareby,",123,45,168,4,2 081,2620000
Såld 14 maj 2013,Duvesjön 370,"Duvesjön,",118,4,122,4,928,2770000
Såld 9 maj 2013,Alekärr 153,"Romelanda,",150,8,158,8,1 411,2800000
Såld 8 maj 2013,Munkegärdegatan 353,"Munkegärde,",107,4,111,4,612,2630000
Såld 30 april 2013,Staby 490,"Kärna,",92,60,152,4,2 230,2500000
Såld 30 april 2013,Skeppsholmsgatan 3,"Centralt,",95,3,98,4,780,3200000
Såld 30 april 2013,Flateby 500,"Kärna - Harestad,",110,68,178,6,4 215,2610000
Såld 21 april 2013,Stenåldersgatan 4,"Ytterby - Stället,",107,5,112,5,459,2775000
Såld 18 april 2013,Ulvesund 419,"Ytterby,",65,15,80,3,688,2150000
Såld 17 april 2013,Östra Trädal 360,"Ytterby - Östra Trädal,",160,80,240,7,11 627,3400000
Såld 17 april 2013,Dösebacka 640,"Dösebacka,",45,2,47,2,1 455,1600000
Såld 13 april 2013,Åseby Österväg 28,"Bohuslän,",70,3,73,3,1 263,1550000
Såld 11 april 2013,Plogvägen 188,"Ullstorp,",122,5,127,5,263,3300000
Såld 10 april 2013,Ringby 164,"Kareby,",128,32,160,4,1 300,3250000
Såld 8 april 2013,Jorsalagatan 5,"Iskällan,",185,36,221,6,860,4100000
Såld 21 mars 2013,Egnahemsgatan 10,"Centralt,",65,65,130,3,446,2825000
Såld 20 mars 2013,Källeröd 220,"Kareby,",61,2,63,2,1 696,1480000
Såld 8 mars 2013,Bokstigen 4,"Centralt,",140,50,190,5,1 661,3330000
Såld 26 februari 2013,Hällristningsgatan 8,"Ytterby - Stället,",103,4,107,4,262,2725000
